(supertux-level
  (version 2)
  (name (_ "Barracks"))
  (author "Matthew")
  (sector
    (name "main")
    (gravity 10)
    (ambient-light 1 1 1)
    (music "music/chipdisko.ogg")
    (spawnpoint
      (x 100)
      (y 170)
      (name "main")
    )
    (background
      (scroll-offset-x 0)
      (scroll-offset-y 0)
      (scroll-speed-x 0)
      (scroll-speed-y 0)
      (speed 0.5)
      (speed_y 0)
      (image "images/background/arctis.jpg")
    )
    (tilemap
      (draw-target "normal")
      (width 80)
      (height 15)
      (speed 1)
      (solid #t)
      (z-pos 0)
      (tiles 65 65 65 65 65 65 65 65 65 65 65 65 65 65 65 65 65 65 65 65 65 65 65 65 65 65 65 65 65 65 65 65 65 65 65 65 65 65 65 65 65 65 65 65 65 65 65 65 65 65 65 65 65 65 65 65 65 65 65 65 65 65 65 65 65 65 65 65 65 65 65 65 65 65 65 65 65 65 65 65 0 0 0 0 0 0 0 0 0 68 68 0 0 0 0 0 0 0 0 0 0 0 0 0 0 0 0 0 0 0 0 0 0 0 0 0 0 0 0 0 0 0 0 0 0 0 0 0 0 0 0 0 0 0 0 0 0 0 0 0 0 0 0 0 0 0 0 0 0 0 0 0 0 0 0 130 133 130 132 0 0 0 0 0 0 0 0 0 0 68 68 0 0 0 0 0 0 0 0 0 0 0 0 0 0 0 0 0 0 0 0 0 0 0 0 0 0 0 0 0 0 0 0 0 0 0 0 0 0 0 0 0 0 0 0 0 0 0 0 0 0 0 0 0 0 0 0 0 0 0 0 0 0 0 0 129 133 129 132 0 0 0 0 0 0 0 0 0 0 68 68 0 0 0 0 0 0 0 0 0 0 0 65 65 65 65 65 65 65 65 65 0 0 0 0 0 0 0 0 0 0 0 0 0 0 0 0 0 0 0 0 0 0 0 0 0 0 0 0 0 0 0 0 0 0 0 0 0 0 0 0 0 0 0 0 129 133 129 132 0 0 0 0 0 0 0 0 0 0 68 68 0 0 0 0 0 0 0 0 0 0 0 65 65 65 65 65 65 65 65 65 65 0 0 0 0 0 0 0 0 0 0 0 0 0 0 0 0 0 0 83 0 0 0 0 0 0 0 0 0 0 0 0 0 0 0 0 0 0 0 0 0 0 0 0 129 133 129 132 0 0 0 0 0 0 0 0 0 0 68 68 0 0 0 0 0 0 0 0 0 0 0 65 0 0 0 0 0 0 65 65 65 65 0 0 0 0 0 0 0 0 0 0 0 0 0 0 0 0 0 0 0 0 0 0 0 0 0 0 0 0 0 0 0 0 0 0 0 0 0 0 0 0 0 0 129 133 129 132 0 0 0 0 0 0 0 0 0 0 68 68 0 0 0 0 0 0 0 0 0 0 0 65 0 0 0 0 0 0 65 65 65 65 65 0 0 0 0 0 0 0 0 0 0 0 0 0 0 0 134 135 0 0 0 0 0 0 0 0 0 0 0 0 0 0 0 0 0 0 0 0 0 0 0 0 129 133 129 132 0 0 0 0 0 0 0 44 0 0 68 68 0 0 0 0 0 0 65 65 65 65 65 65 65 65 65 65 65 65 65 65 65 65 65 65 0 0 0 0 0 0 0 0 0 0 0 0 0 0 0 0 0 0 0 0 0 0 0 0 0 0 0 0 0 0 0 0 0 0 0 0 0 0 0 0 129 133 129 132 0 68 68 68 0 0 0 68 68 68 68 68 0 0 0 0 44 65 65 65 103 0 103 65 65 65 65 65 65 65 65 65 65 65 65 65 65 0 0 0 0 0 0 0 0 0 0 0 0 0 0 0 0 0 0 0 0 0 0 0 0 0 0 0 0 0 0 0 0 0 0 0 0 0 0 0 129 133 129 132 0 0 0 0 0 0 0 0 0 0 68 68 0 0 0 0 65 65 65 65 102 102 102 65 0 0 0 0 0 0 65 65 65 65 65 65 65 65 0 0 0 0 0 0 0 0 0 65 65 65 65 65 65 0 0 0 0 0 0 0 0 0 0 0 0 0 0 0 0 0 0 0 0 0 0 0 129 133 129 132 0 0 0 0 0 0 0 0 0 0 68 68 0 0 0 65 65 65 65 65 0 0 0 65 0 0 0 0 0 0 65 65 44 44 44 44 44 65 65 65 0 0 0 0 0 0 0 129 0 0 0 0 129 0 0 0 0 0 0 0 0 0 0 0 0 0 0 0 0 0 0 0 0 0 80 80 129 133 129 132 0 68 68 68 0 0 0 68 68 68 68 68 0 0 65 65 65 65 65 65 102 102 102 65 65 65 65 65 65 65 65 65 44 44 102 44 44 65 65 65 65 0 102 83 102 0 0 129 0 0 0 0 129 0 0 0 0 0 0 0 0 0 0 0 0 0 0 0 0 0 0 0 0 0 79 79 129 133 129 132 0 0 0 0 0 0 0 0 0 0 0 0 0 104 65 65 65 65 65 65 128 0 128 65 65 65 65 65 65 65 65 65 44 44 44 44 44 0 65 65 65 65 0 0 0 0 0 129 0 0 0 0 129 0 0 0 0 0 0 0 0 0 0 0 0 0 0 0 0 0 0 0 0 0 79 79 129 133 129 132 0 0 0 0 0 0 0 0 44 0 0 0 0 104 65 65 65 65 65 65 0 0 0 0 0 0 0 0 0 0 0 65 44 44 44 44 44 0 65 65 65 65 65 0 0 0 0 129 0 0 0 44 129 0 0 0 0 0 0 0 0 0 0 0 0 0 0 0 0 0 0 0 0 0 79 79 129 133 129 132 0 65 65 65 65 65 65 65 65 65 65 65 65 65 65 65 65 65 65 65 65 65 65 65 65 65 65 65 65 65 65 65 65 65 65 65 65 65 65 65 65 65 65 65 65 65 65 65 65 65 65 65 65 65 65 65 65 65 65 65 65 65 65 65 65 65 65 65 65 65 65 65 65 65 65 65 65 65 65 65 65)
    )
    (tilemap
      (draw-target "normal")
      (width 80)
      (height 15)
      (speed 1)
      (solid #f)
      (z-pos -100)
      (tiles 66 66 66 66 66 66 66 66 66 66 66 66 66 66 66 66 66 64 64 64 64 64 64 64 64 64 64 64 64 64 64 64 64 64 64 64 64 64 64 64 64 64 64 64 64 64 64 64 64 64 64 64 64 64 64 64 64 64 64 64 64 64 64 64 64 64 64 64 64 64 64 64 64 64 64 64 64 64 64 64 66 66 66 66 66 66 66 66 66 66 66 66 66 66 66 66 66 64 64 64 64 64 64 64 64 64 64 64 64 64 64 64 64 64 64 64 64 64 64 64 64 64 64 64 64 64 64 64 64 64 64 64 64 64 64 64 64 64 64 64 64 64 64 64 64 64 64 64 64 64 64 64 64 64 64 64 64 64 0 0 66 66 66 66 66 66 66 66 66 66 66 66 66 66 66 66 66 64 64 64 64 64 64 64 64 64 64 64 64 64 64 64 64 64 64 64 64 64 64 64 64 64 64 64 64 64 64 64 64 64 64 64 64 64 64 64 64 64 64 64 64 64 64 64 64 64 64 64 64 64 64 64 64 64 64 64 64 64 0 0 66 66 66 66 66 66 66 66 66 66 66 66 66 66 66 66 66 64 64 64 64 64 64 64 64 64 64 64 64 64 64 64 64 64 64 64 64 64 64 64 64 64 64 64 64 64 64 64 64 64 64 64 64 64 64 64 64 64 64 64 64 64 64 64 64 64 64 64 64 64 64 64 64 64 64 64 64 64 0 0 66 66 66 66 66 66 66 66 66 66 66 66 66 66 66 66 66 64 64 64 64 64 64 64 64 64 64 64 64 64 64 64 64 64 64 64 64 64 64 64 64 64 64 64 64 64 64 64 64 64 64 64 64 64 64 64 64 64 64 64 64 64 64 64 64 64 64 64 64 64 64 64 64 64 64 64 64 64 0 0 66 66 66 66 66 66 66 66 66 66 66 66 66 66 66 66 66 64 64 64 64 64 64 64 64 64 64 64 64 64 64 64 64 64 64 64 64 64 64 64 64 64 64 64 64 64 64 64 64 64 64 64 64 64 64 64 64 64 64 64 64 64 64 64 64 64 64 64 64 64 64 64 64 64 64 64 64 64 0 0 66 66 66 66 66 66 66 66 66 66 66 66 66 66 66 66 66 64 64 64 64 64 64 64 64 64 64 64 64 64 64 64 64 64 64 64 64 64 64 64 64 64 64 64 64 64 64 64 64 64 64 64 64 64 64 64 64 64 64 64 64 64 64 64 64 64 64 64 64 64 64 64 64 64 64 64 64 64 0 0 66 66 66 66 66 66 66 66 66 66 66 66 66 66 66 66 66 64 64 64 64 64 64 64 64 64 64 64 64 64 64 64 64 64 64 64 64 64 64 64 64 64 64 64 64 64 64 64 64 64 64 64 64 64 64 64 64 64 64 64 64 64 64 64 64 64 64 64 64 64 64 64 64 64 64 64 64 64 0 0 66 66 66 66 66 66 66 66 66 66 66 66 66 66 66 66 66 64 64 64 64 64 64 64 64 64 64 64 64 64 64 64 64 64 64 64 64 64 64 64 64 64 64 64 64 64 64 64 64 64 64 64 64 64 64 64 64 64 64 64 64 64 64 64 64 64 64 64 64 64 64 64 64 64 64 64 64 64 0 0 66 66 66 66 66 66 66 66 66 66 66 66 66 66 66 66 66 64 64 64 64 64 64 64 64 64 64 64 64 64 64 64 64 64 64 64 64 64 64 64 64 64 64 64 64 64 64 64 64 64 64 64 64 64 64 64 64 64 64 64 64 64 64 64 64 64 64 64 64 64 64 64 64 64 64 64 64 64 0 0 66 66 66 66 66 66 66 66 66 66 66 66 66 66 66 66 66 64 64 64 64 64 64 64 64 64 64 64 64 64 64 64 64 64 64 64 64 64 64 64 64 64 64 64 64 64 64 64 64 64 64 64 64 64 64 64 64 64 64 64 64 64 64 64 64 64 64 64 64 64 64 64 64 64 64 64 64 64 0 0 66 66 66 66 66 66 66 66 66 66 66 66 66 66 66 66 66 64 64 64 64 64 64 64 64 64 64 64 64 64 64 64 64 64 64 64 64 64 64 64 64 64 64 64 64 64 64 64 64 64 64 64 64 64 64 64 64 64 64 64 64 64 64 64 64 64 64 64 64 64 64 64 64 64 64 64 64 64 0 0 66 66 66 66 66 66 66 66 66 66 66 66 66 66 66 66 66 64 64 64 64 64 64 64 64 64 64 64 64 64 64 64 64 64 64 64 64 64 64 64 64 64 64 64 64 64 64 64 64 64 64 64 64 64 64 64 64 64 64 64 64 64 64 64 64 64 64 64 64 64 64 64 64 64 64 64 64 64 0 0 66 66 66 66 66 66 66 66 66 66 66 66 66 66 66 66 66 64 64 64 64 64 64 64 64 64 64 64 64 64 64 64 64 64 64 64 64 64 64 64 64 64 64 64 64 64 64 64 64 64 64 64 64 64 64 64 64 64 64 64 64 64 64 64 64 64 64 64 64 64 64 64 64 64 64 64 64 64 0 0 66 66 66 66 66 66 66 66 66 66 66 66 66 66 66 66 66 64 64 64 64 64 64 64 64 64 64 64 64 64 64 64 64 64 64 64 64 64 64 64 64 64 64 64 64 64 64 64 64 64 64 64 64 64 64 64 64 64 64 64 64 64 64 64 64 64 64 64 64 64 64 64 64 64 64 64 64 64 64 64)
    )
    (tilemap
      (draw-target "normal")
      (width 80)
      (height 15)
      (speed 1)
      (solid #f)
      (z-pos 200)
      (tiles 0 0 0 0 0 0 0 0 0 0 0 0 0 0 0 0 0 0 0 0 0 0 0 0 0 0 0 0 0 0 0 0 0 0 0 0 0 0 0 0 0 0 0 0 0 0 0 0 0 0 0 0 0 0 0 0 0 0 0 0 0 0 0 0 64 64 64 64 64 64 64 64 64 64 64 64 64 0 0 0 0 0 0 0 0 0 0 0 0 0 0 0 0 0 0 0 0 0 0 0 0 0 0 0 0 0 0 0 0 0 0 0 0 0 0 0 0 0 0 0 0 0 0 0 0 0 0 0 0 0 0 0 0 0 0 0 0 0 0 0 0 0 0 0 0 0 0 0 0 0 0 0 0 0 0 0 0 0 0 0 0 0 0 0 0 0 0 0 0 0 0 0 0 0 0 0 0 0 0 0 0 0 0 0 0 0 0 0 0 0 0 0 0 0 0 0 0 0 0 0 0 0 0 0 0 0 0 0 0 0 0 0 0 0 0 0 0 0 0 0 0 0 0 0 0 0 0 0 0 0 0 0 0 0 0 0 0 0 0 0 0 0 0 0 0 0 0 0 0 0 0 0 0 0 0 0 0 0 0 0 0 0 0 0 0 0 0 0 0 0 0 0 0 0 0 0 0 0 0 0 0 0 0 0 0 0 0 0 0 0 0 0 0 0 0 0 0 0 0 0 0 0 0 0 0 0 0 0 0 0 0 0 0 0 0 0 0 0 0 0 0 0 0 0 0 0 0 0 0 0 0 0 0 0 0 0 0 0 0 0 0 0 0 0 0 0 0 0 0 0 0 0 0 0 0 0 0 0 0 0 0 0 0 0 0 0 0 0 0 0 0 0 0 0 0 0 0 0 0 0 0 0 0 0 0 0 0 0 0 0 0 0 0 0 0 0 0 0 0 0 0 0 0 0 0 0 0 0 0 0 0 0 0 0 0 0 0 0 0 0 0 0 0 0 0 0 0 0 0 0 0 0 0 0 0 0 0 0 0 0 0 0 0 0 0 0 0 0 0 0 0 0 0 0 0 0 0 0 0 0 0 0 0 0 0 0 0 0 0 0 0 0 0 0 0 0 0 0 0 0 0 0 0 0 0 0 0 0 0 0 0 0 0 0 0 0 0 0 0 0 0 0 0 0 0 0 0 0 0 0 0 0 0 0 0 0 0 0 0 0 0 0 0 0 0 0 0 0 0 0 0 0 0 0 0 0 0 0 0 0 0 0 0 0 0 0 0 0 0 0 0 0 0 0 0 0 0 0 0 0 0 0 0 0 0 0 0 0 0 0 0 0 0 0 0 0 0 0 0 0 0 0 0 0 0 0 0 0 0 0 0 0 0 0 0 0 0 0 0 0 0 0 0 0 0 0 0 0 0 0 0 0 0 0 0 0 0 0 0 0 0 0 0 0 0 0 0 0 0 0 0 0 0 0 0 0 0 0 0 0 0 0 0 0 0 0 0 0 0 0 0 0 0 0 0 0 0 0 0 0 0 0 0 0 0 0 0 0 0 0 0 0 0 0 0 0 0 0 0 0 0 0 0 0 0 0 0 0 0 0 0 0 0 0 0 0 0 0 0 0 0 0 0 0 0 0 0 0 0 0 0 0 0 0 0 0 0 0 0 0 0 0 0 0 0 0 0 0 0 0 0 0 0 0 0 0 0 0 0 0 0 0 0 0 0 0 0 0 0 0 0 0 0 0 0 0 0 0 0 0 0 0 0 0 0 0 0 0 0 0 0 0 0 0 0 0 0 0 0 0 0 0 0 0 0 0 0 0 0 0 0 0 0 0 0 0 0 0 0 0 0 0 0 0 0 0 0 0 0 0 0 0 0 0 0 0 0 0 0 0 0 0 0 0 0 0 0 0 0 0 0 0 0 0 0 0 0 0 0 0 0 0 0 0 0 0 0 0 0 0 0 0 0 0 0 0 0 0 0 0 0 0 0 0 0 0 0 0 0 0 0 0 0 0 0 0 0 0 0 0 0 0 0 0 0 0 0 0 0 0 0 0 0 0 0 0 0 0 0 0 0 0 0 0 0 0 0 0 0 0 0 0 0 0 0 0 0 0 0 0 0 0 0 0 0 0 0 0 0 0 0 0 0 0 0 0 0 0 0 0 0 0 0 0 0 0 0 0 0 0 0 0 0 0 0 0 0 0 0 0 0 0 0 0 0 0 0 0 0 0 0 0 0 0 0 0 0 0 0 0 0 0 0 0 0 0 0 0 0 0 0 0 0 0 0 0 0 0 0 0 0 0 0 0 0 0 0 0 0 0 0 0 0 0 0 0 0 0 0 0 0 0 0 0 0 0 0 0 0 0 0 0 0 0 0 0 0 0 0 0 0 0 0 0 0 0 0 0 0 0 0 0 0 0 0 0 0 0 0 0 0 0 0 0 0 0 0 0 0 0 0 0 0 0 0 0 0 0 0 0 0 0 0 0 0 0 0 0 0 0 0 0 0 0 0 0 0 0 0 0 0 0 0 0 0 0 0 0 0 0 0 0 0 0 0 0 0 0 0 0 0 0 0 0 0 0 0 0 0 0 0 0 0 0 0 0 0 0 0 0 0 0 0 0 0 0 0 0 0 0 0 0 0 0 0 0 0 0 0 0 0 0 0 0 0 0 0 0 0 0 0 0 0 0 0 0 0 0 0 0 0 0 0 0 0 0 0 0 0 0 0 0 0 0 0 0 0 0 0 0)
    )
    (jumpy
      (x 230)
      (y 177)
      (sprite "images/creatures/snowjumpy/snowjumpy.sprite")
      (direction "left")
    )
    (jumpy
      (x 28)
      (y 165)
      (sprite "images/creatures/snowjumpy/snowjumpy.sprite")
      (direction "right")
    )
    (snowball
      (x 237)
      (y 311)
      (sprite "images/creatures/snowball/snowball.sprite")
      (direction "left")
    )
    (snowball
      (x 30)
      (y 309)
      (sprite "images/creatures/snowball/snowball.sprite")
      (direction "right")
    )
    (stalactite
      (x 381)
      (y 34)
      (sprite "images/creatures/stalactite/stalactite.sprite")
      (direction "left")
    )
    (stalactite
      (x 418)
      (y 35)
      (sprite "images/creatures/stalactite/stalactite.sprite")
      (direction "left")
    )
    (stalactite
      (x 456)
      (y 32)
      (sprite "images/creatures/stalactite/stalactite.sprite")
      (direction "left")
    )
    (stalactite
      (x 492)
      (y 34)
      (sprite "images/creatures/stalactite/stalactite.sprite")
      (direction "left")
    )
    (stalactite
      (x 525)
      (y 34)
      (sprite "images/creatures/stalactite/stalactite.sprite")
      (direction "left")
    )
    (stalactite
      (x 351)
      (y 35)
      (sprite "images/creatures/stalactite/stalactite.sprite")
      (direction "left")
    )
    (stalactite
      (x 558)
      (y 37)
      (sprite "images/creatures/stalactite/stalactite.sprite")
      (direction "left")
    )
    (mrbomb
      (x 882)
      (y 181)
      (sprite "images/creatures/mr_bomb/mr_bomb.sprite")
      (direction "left")
    )
    (mrbomb
      (x 839)
      (y 180)
      (sprite "images/creatures/mr_bomb/mr_bomb.sprite")
      (direction "left")
    )
    (mrbomb
      (x 792)
      (y 178)
      (sprite "images/creatures/mr_bomb/mr_bomb.sprite")
      (direction "left")
    )
    (mrbomb
      (x 737)
      (y 176)
      (sprite "images/creatures/mr_bomb/mr_bomb.sprite")
      (direction "left")
    )
    (mrbomb
      (x 881)
      (y 309)
      (sprite "images/creatures/mr_bomb/mr_bomb.sprite")
      (direction "left")
    )
    (mrbomb
      (x 836)
      (y 311)
      (sprite "images/creatures/mr_bomb/mr_bomb.sprite")
      (direction "left")
    )
    (mrbomb
      (x 793)
      (y 310)
      (sprite "images/creatures/mr_bomb/mr_bomb.sprite")
      (direction "left")
    )
    (mrbomb
      (x 751)
      (y 310)
      (sprite "images/creatures/mr_bomb/mr_bomb.sprite")
      (direction "left")
    )
    (bouncingsnowball
      (x 636)
      (y 174)
      (sprite "images/creatures/bouncing_snowball/bouncing_snowball.sprite")
      (direction "left")
    )
    (bouncingsnowball
      (x 613)
      (y 135)
      (sprite "images/creatures/bouncing_snowball/bouncing_snowball.sprite")
      (direction "left")
    )
    (bouncingsnowball
      (x 649)
      (y 87)
      (sprite "images/creatures/bouncing_snowball/bouncing_snowball.sprite")
      (direction "left")
    )
    (bouncingsnowball
      (x 599)
      (y 80)
      (sprite "images/creatures/bouncing_snowball/bouncing_snowball.sprite")
      (direction "left")
    )
    (bouncingsnowball
      (x 641)
      (y 50)
      (sprite "images/creatures/bouncing_snowball/bouncing_snowball.sprite")
      (direction "left")
    )
    (bouncingsnowball
      (x 563)
      (y 158)
      (sprite "images/creatures/bouncing_snowball/bouncing_snowball.sprite")
      (direction "left")
    )
    (flame
      (x 597)
      (y 90)
      (sprite "images/creatures/flame/flame.sprite")
      (direction "left")
    )
    (flame
      (x 1253)
      (y 184)
      (sprite "images/creatures/flame/flame.sprite")
      (direction "left")
    )
    (flame
      (x 1253)
      (y 184)
      (sprite "images/creatures/flame/flame.sprite")
      (direction "left")
    )
    (flame
      (x 1253)
      (y 184)
      (sprite "images/creatures/flame/flame.sprite")
      (direction "left")
    )
    (flame
      (x 1312)
      (y 157)
      (sprite "images/creatures/flame/flame.sprite")
      (direction "left")
    )
    (stalactite
      (x 2356)
      (y 36)
      (sprite "images/creatures/stalactite/stalactite.sprite")
      (direction "left")
    )
    (stalactite
      (x 2329)
      (y 35)
      (sprite "images/creatures/stalactite/stalactite.sprite")
      (direction "left")
    )
    (stalactite
      (x 2299)
      (y 35)
      (sprite "images/creatures/stalactite/stalactite.sprite")
      (direction "left")
    )
    (stalactite
      (x 2268)
      (y 36)
      (sprite "images/creatures/stalactite/stalactite.sprite")
      (direction "left")
    )
    (stalactite
      (x 2240)
      (y 36)
      (sprite "images/creatures/stalactite/stalactite.sprite")
      (direction "left")
    )
    (flame
      (x 2443)
      (y 89)
      (sprite "images/creatures/flame/flame.sprite")
      (direction "left")
    )
    (flame
      (x 2409)
      (y 89)
      (sprite "images/creatures/flame/flame.sprite")
      (direction "left")
    )
    (flame
      (x 2428)
      (y 115)
      (sprite "images/creatures/flame/flame.sprite")
      (direction "left")
    )
    (flame
      (x 2470)
      (y 84)
      (sprite "images/creatures/flame/flame.sprite")
      (direction "left")
    )
    (flame
      (x 2375)
      (y 88)
      (sprite "images/creatures/flame/flame.sprite")
      (direction "left")
    )
    (flame
      (x 2416)
      (y 79)
      (sprite "images/creatures/flame/flame.sprite")
      (direction "left")
    )
    (flame
      (x 2385)
      (y 109)
      (sprite "images/creatures/flame/flame.sprite")
      (direction "left")
    )
    (flame
      (x 2461)
      (y 114)
      (sprite "images/creatures/flame/flame.sprite")
      (direction "left")
    )
    (flame
      (x 2407)
      (y 135)
      (sprite "images/creatures/flame/flame.sprite")
      (direction "left")
    )
    (flame
      (x 2461)
      (y 140)
      (sprite "images/creatures/flame/flame.sprite")
      (direction "left")
    )
    (flame
      (x 2349)
      (y 102)
      (sprite "images/creatures/flame/flame.sprite")
      (direction "left")
    )
    (flame
      (x 2375)
      (y 127)
      (sprite "images/creatures/flame/flame.sprite")
      (direction "left")
    )
    (flame
      (x 2324)
      (y 83)
      (sprite "images/creatures/flame/flame.sprite")
      (direction "left")
    )
    (flame
      (x 2339)
      (y 129)
      (sprite "images/creatures/flame/flame.sprite")
      (direction "left")
    )
    (flame
      (x 2352)
      (y 139)
      (sprite "images/creatures/flame/flame.sprite")
      (direction "left")
    )
    (flame
      (x 2306)
      (y 117)
      (sprite "images/creatures/flame/flame.sprite")
      (direction "left")
    )
    (flame
      (x 2303)
      (y 107)
      (sprite "images/creatures/flame/flame.sprite")
      (direction "left")
    )
    (flame
      (x 2294)
      (y 82)
      (sprite "images/creatures/flame/flame.sprite")
      (direction "left")
    )
    (flame
      (x 2262)
      (y 80)
      (sprite "images/creatures/flame/flame.sprite")
      (direction "left")
    )
    (flame
      (x 2244)
      (y 104)
      (sprite "images/creatures/flame/flame.sprite")
      (direction "left")
    )
    (flame
      (x 2263)
      (y 132)
      (sprite "images/creatures/flame/flame.sprite")
      (direction "left")
    )
    (flame
      (x 2280)
      (y 120)
      (sprite "images/creatures/flame/flame.sprite")
      (direction "left")
    )
    (flame
      (x 2288)
      (y 106)
      (sprite "images/creatures/flame/flame.sprite")
      (direction "left")
    )
    (flame
      (x 2307)
      (y 144)
      (sprite "images/creatures/flame/flame.sprite")
      (direction "left")
    )
    (flame
      (x 2244)
      (y 138)
      (sprite "images/creatures/flame/flame.sprite")
      (direction "left")
    )
    (flame
      (x 2232)
      (y 96)
      (sprite "images/creatures/flame/flame.sprite")
      (direction "left")
    )
    (flame
      (x 2207)
      (y 97)
      (sprite "images/creatures/flame/flame.sprite")
      (direction "left")
    )
    (flame
      (x 2198)
      (y 110)
      (sprite "images/creatures/flame/flame.sprite")
      (direction "left")
    )
    (flame
      (x 2209)
      (y 121)
      (sprite "images/creatures/flame/flame.sprite")
      (direction "left")
    )
    (flame
      (x 2209)
      (y 127)
      (sprite "images/creatures/flame/flame.sprite")
      (direction "left")
    )
    (flame
      (x 2188)
      (y 105)
      (sprite "images/creatures/flame/flame.sprite")
      (direction "left")
    )
    (flame
      (x 2219)
      (y 87)
      (sprite "images/creatures/flame/flame.sprite")
      (direction "left")
    )
    (flame
      (x 2208)
      (y 86)
      (sprite "images/creatures/flame/flame.sprite")
      (direction "left")
    )
    (flame
      (x 2159)
      (y 108)
      (sprite "images/creatures/flame/flame.sprite")
      (direction "left")
    )
    (flame
      (x 2175)
      (y 131)
      (sprite "images/creatures/flame/flame.sprite")
      (direction "left")
    )
    (flame
      (x 2154)
      (y 127)
      (sprite "images/creatures/flame/flame.sprite")
      (direction "left")
    )
    (flame
      (x 2077)
      (y 109)
      (sprite "images/creatures/flame/flame.sprite")
      (direction "left")
    )
    (flame
      (x 2070)
      (y 103)
      (sprite "images/creatures/flame/flame.sprite")
      (direction "left")
    )
    (flame
      (x 2088)
      (y 89)
      (sprite "images/creatures/flame/flame.sprite")
      (direction "left")
    )
    (flame
      (x 2058)
      (y 110)
      (sprite "images/creatures/flame/flame.sprite")
      (direction "left")
    )
    (flame
      (x 2158)
      (y 94)
      (sprite "images/creatures/flame/flame.sprite")
      (direction "left")
    )
    (flame
      (x 2139)
      (y 86)
      (sprite "images/creatures/flame/flame.sprite")
      (direction "left")
    )
    (flame
      (x 2155)
      (y 94)
      (sprite "images/creatures/flame/flame.sprite")
      (direction "left")
    )
    (bouncingsnowball
      (x 2289)
      (y 277)
      (sprite "images/creatures/bouncing_snowball/bouncing_snowball.sprite")
      (direction "left")
    )
    (bouncingsnowball
      (x 2196)
      (y 256)
      (sprite "images/creatures/bouncing_snowball/bouncing_snowball.sprite")
      (direction "left")
    )
    (bouncingsnowball
      (x 2326)
      (y 223)
      (sprite "images/creatures/bouncing_snowball/bouncing_snowball.sprite")
      (direction "left")
    )
    (bouncingsnowball
      (x 2240)
      (y 201)
      (sprite "images/creatures/bouncing_snowball/bouncing_snowball.sprite")
      (direction "left")
    )
    (bouncingsnowball
      (x 2309)
      (y 176)
      (sprite "images/creatures/bouncing_snowball/bouncing_snowball.sprite")
      (direction "left")
    )
    (bouncingsnowball
      (x 2263)
      (y 241)
      (sprite "images/creatures/bouncing_snowball/bouncing_snowball.sprite")
      (direction "left")
    )
    (bouncingsnowball
      (x 2337)
      (y 277)
      (sprite "images/creatures/bouncing_snowball/bouncing_snowball.sprite")
      (direction "left")
    )
    (bouncingsnowball
      (x 2270)
      (y 328)
      (sprite "images/creatures/bouncing_snowball/bouncing_snowball.sprite")
      (direction "left")
    )
    (bouncingsnowball
      (x 2227)
      (y 292)
      (sprite "images/creatures/bouncing_snowball/bouncing_snowball.sprite")
      (direction "left")
    )
    (spiky
      (x 2279)
      (y 404)
      (sprite "images/creatures/spiky/spiky.sprite")
      (direction "left")
    )
    (spiky
      (x 2224)
      (y 404)
      (sprite "images/creatures/spiky/spiky.sprite")
      (direction "left")
    )
    (spiky
      (x 2169)
      (y 405)
      (sprite "images/creatures/spiky/spiky.sprite")
      (direction "left")
    )
    (spiky
      (x 2119)
      (y 406)
      (sprite "images/creatures/spiky/spiky.sprite")
      (direction "left")
    )
    (spiky
      (x 2075)
      (y 405)
      (sprite "images/creatures/spiky/spiky.sprite")
      (direction "left")
    )
    (spiky
      (x 2025)
      (y 405)
      (sprite "images/creatures/spiky/spiky.sprite")
      (direction "left")
    )
    (spiky
      (x 1963)
      (y 412)
      (sprite "images/creatures/spiky/spiky.sprite")
      (direction "left")
    )
    (flyingsnowball
      (x 2040)
      (y 255)
      (sprite "images/creatures/flying_snowball/flying_snowball.sprite")
      (direction "left")
    )
    (flyingsnowball
      (x 1990)
      (y 257)
      (sprite "images/creatures/flying_snowball/flying_snowball.sprite")
      (direction "left")
    )
    (flyingsnowball
      (x 2094)
      (y 262)
      (sprite "images/creatures/flying_snowball/flying_snowball.sprite")
      (direction "left")
    )
    (flyingsnowball
      (x 1943)
      (y 263)
      (sprite "images/creatures/flying_snowball/flying_snowball.sprite")
      (direction "left")
    )
    (flyingsnowball
      (x 1886)
      (y 262)
      (sprite "images/creatures/flying_snowball/flying_snowball.sprite")
      (direction "left")
    )
    (mrbomb
      (x 1884)
      (y 400)
      (sprite "images/creatures/mr_bomb/mr_bomb.sprite")
      (direction "left")
    )
    (mrbomb
      (x 1812)
      (y 409)
      (sprite "images/creatures/mr_bomb/mr_bomb.sprite")
      (direction "left")
    )
    (mrbomb
      (x 1758)
      (y 408)
      (sprite "images/creatures/mr_bomb/mr_bomb.sprite")
      (direction "left")
    )
    (stalactite
      (x 1667)
      (y 35)
      (sprite "images/creatures/stalactite/stalactite.sprite")
      (direction "left")
    )
    (mriceblock
      (x 1559)
      (y 250)
      (sprite "images/creatures/mr_iceblock/mr_iceblock.sprite")
      (direction "left")
    )
    (mriceblock
      (x 1499)
      (y 245)
      (sprite "images/creatures/mr_iceblock/mr_iceblock.sprite")
      (direction "left")
    )
    (mriceblock
      (x 1623)
      (y 243)
      (sprite "images/creatures/mr_iceblock/mr_iceblock.sprite")
      (direction "left")
    )
    (flyingsnowball
      (x 1454)
      (y 121)
      (sprite "images/creatures/flying_snowball/flying_snowball.sprite")
      (direction "left")
    )
    (flyingsnowball
      (x 1515)
      (y 111)
      (sprite "images/creatures/flying_snowball/flying_snowball.sprite")
      (direction "left")
    )
    (flyingsnowball
      (x 1368)
      (y 122)
      (sprite "images/creatures/flying_snowball/flying_snowball.sprite")
      (direction "left")
    )
    (spiky
      (x 1547)
      (y 411)
      (sprite "images/creatures/spiky/spiky.sprite")
      (direction "left")
    )
    (flyingsnowball
      (x 1819)
      (y -32)
      (sprite "images/creatures/flying_snowball/flying_snowball.sprite")
      (direction "left")
    )
    (flyingsnowball
      (x 1828)
      (y 259)
      (sprite "images/creatures/flying_snowball/flying_snowball.sprite")
      (direction "left")
    )
    (flyingsnowball
      (x 1763)
      (y 261)
      (sprite "images/creatures/flying_snowball/flying_snowball.sprite")
      (direction "left")
    )
    (snowball
      (x 1690)
      (y 405)
      (sprite "images/creatures/snowball/snowball.sprite")
      (direction "left")
    )
    (snowball
      (x 1722)
      (y 377)
      (sprite "images/creatures/snowball/snowball.sprite")
      (direction "left")
    )
    (snowball
      (x 1404)
      (y 406)
      (sprite "images/creatures/snowball/snowball.sprite")
      (direction "left")
    )
    (mrbomb
      (x 2165)
      (y 355)
      (sprite "images/creatures/mr_bomb/mr_bomb.sprite")
      (direction "left")
    )
    (mrbomb
      (x 2111)
      (y 355)
      (sprite "images/creatures/mr_bomb/mr_bomb.sprite")
      (direction "left")
    )
    (mrbomb
      (x 2047)
      (y 356)
      (sprite "images/creatures/mr_bomb/mr_bomb.sprite")
      (direction "left")
    )
    (mrbomb
      (x 1992)
      (y 356)
      (sprite "images/creatures/mr_bomb/mr_bomb.sprite")
      (direction "left")
    )
    (mrbomb
      (x 2559)
      (y 4)
      (sprite "images/creatures/mr_bomb/mr_bomb.sprite")
      (direction "left")
    )
    (camera
      (name "Camera")
      (mode "normal")
    )
  )
)
