(supertux-level
  (version 2)
  (name (_ "Noloks Room!"))
  (author "gabman7")
  (sector
    (name "main")
    (gravity 10)
    (ambient-light 1 1 1)
    (music "music/chipdisko.ogg")
    (spawnpoint
      (x 100)
      (y 170)
      (name "main")
    )
    (gradient
      (z-pos -300)
      (top_color 0.7843137383 0 0)
      (bottom_color 0 0 0)
    )
    (tilemap
      (draw-target "normal")
      (width 100)
      (height 15)
      (speed 1)
      (solid #t)
      (z-pos 0)
      (tiles 0 0 0 0 0 0 0 0 0 0 0 104 83 104 83 104 83 104 83 104 0 0 0 0 0 0 0 0 0 0 0 0 0 0 0 0 0 0 0 0 0 0 0 0 61 0 0 0 0 0 0 0 0 0 0 0 0 0 0 0 0 0 0 0 0 0 0 0 0 0 0 0 0 0 0 0 0 0 0 0 0 0 0 0 0 0 0 0 0 0 0 0 0 0 0 133 48 48 48 48 0 0 0 0 0 0 0 0 0 0 0 0 0 0 0 0 0 0 0 0 0 0 0 0 0 0 0 0 0 0 0 0 0 0 0 0 0 0 0 0 0 0 0 0 61 0 0 0 0 61 61 61 61 61 61 0 0 0 0 0 0 0 0 0 0 0 0 0 0 0 0 0 0 0 0 0 0 0 0 0 0 0 0 0 0 0 0 0 0 0 0 0 0 0 0 133 48 48 48 48 0 0 0 0 0 0 0 0 0 0 0 0 0 0 0 0 0 0 0 0 0 0 0 0 0 0 0 0 0 0 0 0 0 0 0 0 0 0 0 0 0 0 0 0 61 0 0 0 0 0 0 0 0 0 61 62 0 0 0 0 0 0 0 0 0 0 0 0 0 0 0 0 0 0 0 0 0 0 0 0 0 0 0 0 0 0 0 0 0 0 0 0 0 0 0 133 48 48 48 48 0 0 0 0 0 0 0 0 0 0 0 84 84 84 84 84 84 84 84 84 0 0 0 0 0 0 0 0 0 0 0 0 0 0 0 0 0 0 0 0 0 0 0 0 61 61 0 0 0 0 0 0 0 0 61 0 0 0 0 0 0 0 0 0 0 0 0 0 0 0 0 0 0 0 0 0 0 0 0 0 0 0 0 0 0 0 0 0 0 0 0 0 0 0 0 133 48 48 48 48 0 0 0 0 0 0 0 0 0 0 84 84 0 0 0 0 0 0 0 0 0 0 0 0 0 0 0 0 0 0 0 0 0 0 0 0 0 0 0 0 0 0 0 0 61 61 61 0 0 0 0 0 0 0 61 0 0 0 0 0 0 0 0 0 0 0 0 0 0 0 0 0 0 0 0 0 0 0 0 0 0 0 0 0 0 0 0 0 0 0 0 0 0 0 0 133 48 48 48 48 0 0 0 0 0 0 0 0 0 0 0 0 0 0 0 0 0 0 0 0 0 0 0 0 0 0 0 0 0 66 66 0 0 0 0 0 0 0 0 0 0 0 0 0 61 61 61 61 0 0 61 0 0 0 61 0 0 0 0 0 0 0 0 0 0 0 0 0 0 0 0 0 0 0 0 0 0 0 0 0 0 0 0 0 0 0 0 0 0 0 0 0 0 0 0 133 48 48 48 48 0 0 0 0 0 0 0 0 0 0 0 0 0 0 0 0 0 0 0 0 0 0 0 0 0 0 0 0 66 66 66 66 0 0 0 0 0 0 0 0 0 0 0 0 61 61 61 61 61 0 61 0 0 61 61 0 0 0 0 0 0 0 0 0 0 0 0 0 0 0 0 0 0 0 0 0 0 0 0 0 0 0 0 0 0 0 0 0 0 0 0 0 0 0 0 133 48 48 48 48 0 0 0 0 0 0 0 0 0 0 0 0 0 0 0 0 0 0 0 0 0 0 0 0 0 0 0 66 66 66 66 66 66 0 0 0 0 0 0 0 0 0 0 0 61 61 61 61 61 61 61 0 0 0 61 62 0 0 0 0 0 0 0 0 0 0 0 0 0 0 0 0 0 0 0 0 0 0 0 0 62 0 0 0 0 0 0 0 0 0 0 0 0 0 0 133 48 48 48 48 0 0 0 0 0 0 0 0 0 0 0 0 0 0 0 0 0 0 0 0 0 0 0 0 0 0 66 66 66 66 66 66 66 66 0 0 0 0 0 0 0 0 0 0 61 61 61 61 61 61 61 0 0 0 61 0 0 0 0 0 0 0 0 0 0 0 0 0 0 0 0 0 0 0 0 0 0 66 0 0 66 0 0 66 0 0 0 0 0 0 0 0 0 0 0 133 48 48 48 48 0 0 0 0 0 0 0 0 0 0 0 0 0 0 0 0 0 0 0 0 0 0 0 0 0 66 66 66 66 66 66 66 66 66 66 0 0 0 0 0 0 0 0 0 61 61 61 61 61 61 61 0 0 0 61 128 0 0 0 0 0 0 0 0 0 0 0 0 0 0 0 0 0 0 0 0 0 66 0 0 66 0 0 66 0 0 66 0 0 0 0 0 0 0 0 133 48 48 48 48 0 102 83 104 83 0 0 0 0 0 0 0 0 0 0 0 0 0 0 0 0 0 0 0 66 66 66 66 66 66 66 66 66 66 66 66 0 0 0 0 0 0 0 0 61 61 61 61 61 61 61 0 0 61 61 0 0 0 0 0 0 0 0 0 0 0 0 0 0 0 0 0 0 0 66 0 0 66 0 0 66 0 0 66 0 0 66 0 0 66 0 0 0 0 0 133 48 48 48 48 0 0 0 0 0 0 0 0 0 0 0 0 0 0 0 0 0 0 0 0 0 0 0 66 66 66 66 66 66 66 66 66 66 66 66 66 66 0 0 0 0 0 0 0 0 0 0 0 0 0 0 0 0 0 61 0 0 0 0 0 134 135 0 134 135 0 134 135 0 134 135 66 134 135 66 134 135 66 134 135 66 134 135 66 134 135 66 134 135 66 134 135 66 134 135 133 48 48 48 48 0 0 0 0 0 0 0 0 0 0 0 0 0 0 0 0 0 0 0 0 0 0 66 66 66 66 66 66 66 66 66 66 66 66 66 66 66 66 0 0 0 0 0 0 0 0 0 0 0 0 0 0 0 0 61 47 0 0 0 0 0 0 0 0 0 0 0 0 0 0 0 66 0 0 66 0 0 66 0 0 66 0 0 66 0 0 66 0 0 66 0 0 66 0 0 133 0 0 0 132 0 0 0 0 0 0 0 0 0 0 84 0 0 0 0 0 0 0 0 84 0 66 66 66 66 66 66 66 66 66 66 66 66 66 66 66 66 66 66 0 0 0 0 0 61 61 61 61 61 61 61 61 61 61 61 0 0 0 0 0 0 0 0 0 0 0 0 0 0 0 0 66 0 0 66 0 0 66 0 0 66 0 0 66 0 0 66 0 0 66 0 0 66 0 0 133 0 0 0 132 66 66 66 66 66 66 66 66 66 66 66 66 66 66 66 66 66 66 66 66 66 66 66 66 66 66 66 66 66 66 66 66 66 66 66 66 66 66 66 66 66 66 66 66 66 66 66 66 66 66 66 66 66 66 66 174 174 174 174 174 66 66 66 66 66 66 66 66 66 66 66 66 66 66 66 66 66 66 66 66 66 66 66 66 66 66 66 66 66 66 66 66 66 66 66 66 66 66 66 66)
    )
    (tilemap
      (draw-target "normal")
      (width 100)
      (height 15)
      (speed 1)
      (solid #f)
      (z-pos -100)
      (tiles 0 0 0 0 0 0 0 0 0 0 0 0 0 0 0 0 0 0 0 0 0 0 0 0 0 0 0 0 0 0 0 0 0 0 0 0 0 0 0 0 0 0 0 0 0 0 0 0 0 0 0 0 0 0 0 0 0 0 0 0 0 0 0 0 0 0 0 0 0 0 0 0 0 0 0 0 0 0 0 0 0 0 0 0 0 0 0 0 0 0 0 0 0 0 0 80 48 48 48 48 0 0 0 0 0 0 0 0 0 0 0 0 0 0 0 0 0 0 0 0 0 0 0 0 0 0 0 0 0 0 0 0 0 0 0 0 0 0 0 0 0 0 0 0 0 0 0 0 0 0 0 0 0 0 0 0 0 0 0 0 0 0 0 0 0 0 0 0 0 0 0 0 0 0 0 0 0 0 0 0 0 0 0 0 0 0 0 0 0 0 0 0 0 0 0 79 48 48 48 48 0 0 0 0 0 0 0 0 0 0 0 0 0 0 0 0 0 0 0 0 0 0 0 0 0 0 0 0 0 0 0 0 0 0 0 0 0 0 0 0 0 0 0 0 0 0 0 0 0 0 0 0 0 0 0 0 0 0 0 0 0 0 0 0 0 0 0 0 0 0 0 0 0 0 0 0 0 0 0 0 0 0 0 0 0 0 0 0 0 0 0 0 0 0 0 79 48 48 48 48 0 0 0 0 0 0 0 0 0 0 0 0 0 0 0 0 0 0 0 0 0 0 0 0 0 0 0 0 0 0 0 0 0 0 0 0 0 0 0 0 0 0 0 0 0 0 0 0 0 0 0 0 0 0 0 0 0 0 0 0 0 0 0 0 0 0 0 0 0 0 0 0 0 0 0 0 0 0 0 0 0 0 0 0 0 0 0 0 0 0 0 0 0 0 0 79 48 48 48 48 0 0 0 0 0 0 0 0 0 0 0 0 0 0 0 0 0 0 0 0 0 0 0 0 0 0 0 0 0 0 0 0 0 0 0 0 0 0 0 0 0 0 0 0 0 0 0 0 0 0 0 0 0 0 0 0 0 0 0 0 0 0 0 0 0 0 0 0 0 0 0 0 0 0 0 0 0 0 0 0 0 0 0 0 0 0 0 0 0 0 0 0 0 0 0 79 48 48 48 48 0 0 0 0 0 0 0 0 0 0 0 0 0 0 0 0 0 0 0 0 0 0 0 0 0 0 0 0 0 0 0 0 0 0 0 0 0 0 0 0 0 0 0 0 0 0 0 0 0 0 0 0 0 0 0 0 0 0 0 0 0 0 0 0 0 0 0 0 0 0 0 0 0 0 0 0 0 0 0 0 0 0 0 0 0 0 0 0 0 0 0 0 0 0 0 79 48 48 48 48 0 0 0 0 0 0 0 0 0 0 0 0 0 0 0 0 0 0 0 0 0 0 0 0 0 0 0 0 0 0 0 0 0 0 0 0 0 0 0 0 0 0 0 0 0 0 0 0 0 0 0 0 0 0 0 0 0 0 0 0 0 0 0 0 0 0 0 0 0 0 0 0 0 0 0 0 0 0 0 0 0 0 0 0 0 0 0 0 0 0 0 0 0 0 0 79 48 48 48 48 0 0 0 0 0 0 0 0 0 0 0 0 0 0 0 0 0 0 0 0 0 0 0 0 0 0 0 0 0 0 0 0 0 0 0 0 0 0 0 0 0 0 0 0 0 0 0 0 0 0 0 0 0 0 0 0 0 0 0 0 0 0 0 0 0 0 0 0 0 0 0 0 0 0 0 0 0 0 0 0 0 0 0 0 0 0 0 0 0 0 0 0 0 0 0 79 48 48 48 48 0 0 0 0 0 0 0 0 0 0 0 0 0 0 0 0 0 0 0 0 0 0 0 0 0 0 0 0 0 0 0 0 0 0 0 0 0 0 0 0 0 0 0 0 0 0 0 0 0 0 0 0 0 0 0 0 0 0 0 0 0 0 0 0 0 0 0 0 0 0 0 0 0 0 0 0 0 0 0 0 0 0 0 0 0 0 0 0 0 0 0 0 0 0 0 79 48 48 48 48 0 0 0 0 0 0 0 0 0 0 0 0 0 0 0 0 0 0 0 0 0 0 0 0 0 0 0 0 0 0 0 0 0 0 0 0 0 0 0 0 0 0 0 0 0 0 0 0 0 0 0 0 0 0 0 0 0 0 0 0 0 0 0 0 0 0 0 0 0 0 0 0 0 0 0 0 0 0 0 0 0 0 0 0 0 0 0 0 0 0 0 0 0 0 0 79 48 48 48 48 0 0 0 0 0 0 0 0 0 0 0 0 0 0 0 0 0 0 0 0 0 0 0 0 0 0 0 0 0 0 0 0 0 0 0 0 0 0 0 0 0 0 0 0 0 0 0 0 0 0 0 0 0 0 0 0 0 0 0 0 0 0 0 0 0 0 0 0 0 0 0 0 0 0 0 0 0 0 0 0 0 0 0 0 0 0 0 0 0 0 0 0 0 0 0 79 48 48 48 48 0 0 0 0 0 0 0 0 0 0 0 0 0 0 0 0 0 0 0 0 0 0 0 0 0 0 0 0 0 0 0 0 0 0 0 0 0 0 0 0 0 0 0 0 0 0 0 0 0 0 0 0 0 0 0 0 0 0 0 0 0 0 0 0 0 0 0 0 0 0 0 0 0 0 0 0 0 0 0 0 0 0 0 0 0 0 0 0 0 0 0 0 0 0 0 79 48 48 48 48 0 0 0 0 0 0 0 0 0 0 0 0 0 0 0 0 0 0 0 0 0 0 0 0 0 0 0 0 0 0 0 0 0 0 0 0 0 0 0 0 0 0 0 0 0 0 0 0 0 0 0 0 0 0 0 0 0 0 0 0 0 0 0 0 0 0 0 0 0 0 0 0 0 0 0 0 0 0 0 0 0 0 0 0 0 0 0 0 0 0 0 0 0 0 0 79 0 0 0 0 0 0 0 0 0 0 0 0 0 0 0 0 0 0 0 0 0 0 0 0 0 0 0 0 0 0 0 0 0 0 0 0 0 0 0 0 0 0 0 0 0 0 0 0 0 0 0 0 0 0 0 0 0 0 0 0 0 0 0 0 0 0 0 0 0 0 0 0 0 0 0 0 0 0 0 0 0 0 0 0 0 0 0 0 0 0 0 0 0 0 0 0 0 0 0 79 0 0 0 0 0 0 0 0 0 0 0 0 0 0 0 0 0 0 0 0 0 0 0 0 0 0 0 0 0 0 0 0 0 0 0 0 0 0 0 0 0 0 0 0 0 0 0 0 0 0 0 0 0 0 0 0 0 0 0 0 0 0 0 0 0 0 0 0 0 0 0 0 0 0 0 0 0 0 0 0 0 0 0 0 0 0 0 0 0 0 0 0 0 0 0 0 0 0 0 0 0 0 0 0)
    )
    (tilemap
      (draw-target "normal")
      (width 100)
      (height 15)
      (speed 1)
      (solid #f)
      (z-pos 200)
      (tiles 0 0 0 0 0 0 0 0 0 0 0 0 0 0 0 0 0 0 0 0 0 0 0 0 0 0 0 0 0 0 0 0 0 0 0 0 0 0 0 0 0 0 0 0 0 0 0 0 0 0 0 0 0 0 0 0 0 0 0 0 0 0 0 0 0 0 0 0 0 0 0 0 0 0 0 0 0 0 0 0 0 0 0 0 0 0 0 0 0 0 0 0 0 0 0 0 0 0 0 0 0 0 0 0 0 0 0 0 0 0 0 0 0 0 0 0 0 0 0 0 0 0 0 0 0 0 0 0 0 0 0 0 0 0 0 0 0 0 0 0 0 0 0 0 0 0 0 0 0 0 0 0 0 0 0 0 0 0 0 0 0 0 0 0 0 0 0 0 0 0 0 0 0 0 0 0 0 0 0 0 0 0 0 0 0 0 0 0 0 0 0 0 0 0 0 0 0 0 0 0 0 0 0 0 0 0 0 0 0 0 0 0 0 0 0 0 0 0 0 0 0 0 0 0 0 0 0 0 0 0 0 0 0 0 0 0 0 0 0 0 0 0 0 0 0 0 0 0 0 0 0 0 0 0 0 0 0 0 0 0 0 0 0 0 0 0 0 0 0 0 0 0 0 0 0 0 0 0 0 0 0 0 0 0 0 0 0 0 0 0 0 0 0 0 0 0 0 0 0 0 0 0 0 0 0 0 0 0 0 0 0 0 0 0 0 0 0 0 0 0 0 0 0 0 0 0 0 0 0 0 0 0 0 0 0 0 0 0 0 0 0 0 0 0 0 0 0 0 0 0 0 0 0 0 0 0 0 0 0 0 0 0 0 0 0 0 0 0 0 0 0 0 0 0 0 0 0 0 0 0 0 0 0 0 0 0 0 0 0 0 0 0 0 0 0 0 0 0 0 0 0 0 0 0 0 0 0 0 0 0 0 0 0 0 0 0 0 0 0 0 0 0 0 0 0 0 0 0 0 0 0 0 0 0 0 0 0 0 0 0 0 0 0 0 0 0 0 0 0 0 0 0 0 0 0 0 0 0 0 0 0 0 0 0 0 0 0 0 0 0 0 0 0 0 0 0 0 0 0 0 0 0 0 0 0 0 0 0 0 0 0 0 0 0 0 0 0 0 0 0 0 0 0 0 0 0 0 0 0 0 0 0 0 0 0 0 0 0 0 0 0 0 0 0 0 0 0 0 0 0 0 0 0 0 0 0 0 0 0 0 0 0 0 0 0 0 0 0 0 0 0 0 0 0 0 0 0 0 0 0 0 0 0 0 0 0 0 0 0 0 0 0 0 0 0 0 0 0 0 0 0 0 0 0 0 0 0 0 0 0 0 0 0 0 0 0 0 0 0 0 0 0 0 0 0 0 0 0 0 0 0 0 0 0 0 0 0 0 0 0 0 0 0 0 0 0 0 0 0 0 0 0 0 0 0 0 0 0 0 0 0 0 0 0 0 0 0 0 0 0 0 0 0 0 0 0 0 0 0 0 0 0 0 0 0 0 0 0 0 0 0 0 0 0 0 0 0 0 0 0 0 0 0 0 0 0 0 0 0 0 0 0 0 0 0 0 0 0 0 0 0 0 0 0 0 0 0 0 0 0 0 0 0 0 0 0 0 0 0 0 0 0 0 0 0 0 0 0 0 0 0 0 0 0 0 0 0 0 0 0 0 0 0 0 0 0 0 0 0 0 0 0 0 0 0 0 0 0 0 0 0 0 0 0 0 0 0 0 0 0 0 0 0 0 0 0 0 0 0 0 0 0 0 0 0 0 0 0 0 0 0 0 0 0 0 0 0 0 0 0 0 0 0 0 0 0 0 0 0 0 0 0 0 0 0 0 0 0 0 0 0 0 0 0 0 0 0 0 0 0 0 0 0 0 0 0 0 0 0 0 0 0 0 0 0 0 0 0 0 0 0 0 0 0 0 0 0 0 0 0 0 0 0 0 0 0 0 0 0 0 0 0 0 0 0 0 0 0 0 0 0 0 0 0 0 0 0 0 0 0 0 0 0 0 0 0 0 0 0 0 0 0 0 0 0 0 0 0 0 0 0 0 0 0 0 0 0 0 0 0 0 0 0 0 0 0 0 0 0 0 0 0 0 0 0 0 0 0 0 0 0 0 0 0 0 0 0 0 0 0 0 0 0 0 0 0 0 0 0 0 0 0 0 0 0 0 0 0 0 0 0 0 0 0 0 0 0 0 0 0 0 0 0 0 0 0 0 0 0 0 0 0 0 0 0 0 0 0 0 0 0 0 0 0 0 0 0 0 0 0 0 0 0 0 0 0 0 0 0 0 0 0 0 0 0 0 0 0 0 0 0 0 0 0 0 0 0 0 0 0 0 0 0 0 0 0 0 0 0 0 0 0 0 0 0 0 0 0 0 0 0 0 0 0 0 0 0 0 0 0 0 0 0 0 0 0 0 0 0 0 0 0 0 0 0 0 0 0 0 0 0 0 0 0 0 0 0 0 0 0 0 0 0 0 0 0 0 0 0 0 0 0 0 0 0 0 0 0 0 0 0 0 0 0 0 0 0 0 0 0 0 0 0 0 0 0 0 0 0 0 0 0 0 0 0 0 0 0 0 0 0 0 0 0 0 0 0 0 0 0 0 0 0 0 0 0 0 0 0 0 0 0 0 0 0 0 0 0 0 0 0 0 0 0 0 0 0 0 0 0 0 0 0 0 0 0 0 0 0 0 0 0 0 0 0 0 0 0 0 0 0 0 0 0 0 0 0 0 0 0 0 0 0 0 0 0 0 0 0 0 0 0 0 0 0 0 0 0 0 0 0 0 0 0 0 0 0 0 0 0 0 0 0 0 0 0 0 0 0 0 0 0 0 0 0 0 0 0 0 0 0 0 0 0 0 0 0 0 0 0 0 0 0 0 0 0 0 0 0 0 0 0 0 0 0 0 53 55 55 55 0 0 0 0 0 0 0 0 0 0 0 0 0 0 0 0 0 0 0 0 0 0 0 0 0 0 0 0 0 0 0 0 0 0 0 0 0 0 0 0 0 0 0 0 0 0 0 0 0 0 0 0 0 0 0 0 0 0 0 0 0 0 0 0 0 0 0 0 0 0 0 0 0 0 0 0 0 0 0 0 0 0 0 0 0 0 0 0 0 0 0 0 0 0 0 0 54 56 56 56 0 0 0 0 0 0 0 0 0 0 0 0 0 0 0 0 0 0 0 0 0 0 0 0 0 0 0 0 0 0 0 0 0 0 0 0 0 0 0 0 0 0 0 0 0 0 0 0 0 0 0 0 0 0 0 0 0 0 0 0 0 0 0 0 0 0 0 0 0 0 0 0 0 0 0 0 0 0 0 0 0 0 0 0 0 0 0 0 0 0 0 0 0 0 0 0 0 0 0 0)
    )
    (jumpy
      (x 178)
      (y 394)
      (sprite "images/creatures/snowjumpy/snowjumpy.sprite")
      (direction "left")
    )
    (flyingsnowball
      (x 235)
      (y 316)
      (sprite "images/creatures/flying_snowball/flying_snowball.sprite")
      (direction "left")
    )
    (flyingsnowball
      (x 287)
      (y 206)
      (sprite "images/creatures/flying_snowball/flying_snowball.sprite")
      (direction "left")
    )
    (snowball
      (x 360)
      (y 415)
      (sprite "images/creatures/snowball/snowball.sprite")
      (direction "left")
    )
    (mrbomb
      (x 410)
      (y 415)
      (sprite "images/creatures/mr_bomb/mr_bomb.sprite")
      (direction "left")
    )
    (jumpy
      (x 466)
      (y 393)
      (sprite "images/creatures/snowjumpy/snowjumpy.sprite")
      (direction "left")
    )
    (mrbomb
      (x 519)
      (y 408)
      (sprite "images/creatures/mr_bomb/mr_bomb.sprite")
      (direction "left")
    )
    (snowball
      (x 569)
      (y 411)
      (sprite "images/creatures/snowball/snowball.sprite")
      (direction "left")
    )
    (spiky
      (x 615)
      (y -32)
      (sprite "images/creatures/spiky/spiky.sprite")
      (direction "left")
    )
    (mrbomb
      (x 665)
      (y 383)
      (sprite "images/creatures/mr_bomb/mr_bomb.sprite")
      (direction "left")
    )
    (mrbomb
      (x 703)
      (y 349)
      (sprite "images/creatures/mr_bomb/mr_bomb.sprite")
      (direction "left")
    )
    (mrbomb
      (x 736)
      (y 319)
      (sprite "images/creatures/mr_bomb/mr_bomb.sprite")
      (direction "left")
    )
    (mrbomb
      (x 766)
      (y 288)
      (sprite "images/creatures/mr_bomb/mr_bomb.sprite")
      (direction "left")
    )
    (mrbomb
      (x 800)
      (y 255)
      (sprite "images/creatures/mr_bomb/mr_bomb.sprite")
      (direction "left")
    )
    (mrbomb
      (x 832)
      (y 223)
      (sprite "images/creatures/mr_bomb/mr_bomb.sprite")
      (direction "left")
    )
    (mrbomb
      (x 864)
      (y 190)
      (sprite "images/creatures/mr_bomb/mr_bomb.sprite")
      (direction "left")
    )
    (mrbomb
      (x 893)
      (y 159)
      (sprite "images/creatures/mr_bomb/mr_bomb.sprite")
      (direction "left")
    )
    (jumpy
      (x 944)
      (y 104)
      (sprite "images/creatures/snowjumpy/snowjumpy.sprite")
      (direction "left")
    )
    (jumpy
      (x 1092)
      (y 238)
      (sprite "images/creatures/snowjumpy/snowjumpy.sprite")
      (direction "left")
    )
    (jumpy
      (x 1263)
      (y 389)
      (sprite "images/creatures/snowjumpy/snowjumpy.sprite")
      (direction "left")
    )
    (flame
      (x 1044)
      (y 205)
      (sprite "images/creatures/flame/flame.sprite")
      (direction "left")
    )
    (flyingsnowball
      (x 1730)
      (y 0)
      (sprite "images/creatures/flying_snowball/flying_snowball.sprite")
      (direction "left")
    )
    (stalactite
      (x 1633)
      (y 66)
      (sprite "images/creatures/stalactite/stalactite.sprite")
      (direction "left")
    )
    (stalactite
      (x 1666)
      (y 65)
      (sprite "images/creatures/stalactite/stalactite.sprite")
      (direction "left")
    )
    (flame
      (x 1862)
      (y 61)
      (sprite "images/creatures/flame/flame.sprite")
      (direction "left")
    )
    (flame
      (x 1860)
      (y 223)
      (sprite "images/creatures/flame/flame.sprite")
      (direction "left")
    )
    (snowball
      (x 2319)
      (y 408)
      (sprite "images/creatures/snowball/snowball.sprite")
      (direction "left")
    )
    (flyingsnowball
      (x 2415)
      (y 397)
      (sprite "images/creatures/flying_snowball/flying_snowball.sprite")
      (direction "left")
    )
    (mriceblock
      (x 2705)
      (y 393)
      (sprite "images/creatures/mr_iceblock/mr_iceblock.sprite")
      (direction "left")
    )
    (flame
      (x 2900)
      (y 355)
      (sprite "images/creatures/flame/flame.sprite")
      (direction "left")
    )
    (spiky
      (x 2892)
      (y 393)
      (sprite "images/creatures/spiky/spiky.sprite")
      (direction "left")
    )
    (jumpy
      (x 2993)
      (y 387)
      (sprite "images/creatures/snowjumpy/snowjumpy.sprite")
      (direction "left")
    )
    (flyingsnowball
      (x 2947)
      (y 312)
      (sprite "images/creatures/flying_snowball/flying_snowball.sprite")
      (direction "left")
    )
    (flyingsnowball
      (x 2850)
      (y 281)
      (sprite "images/creatures/flying_snowball/flying_snowball.sprite")
      (direction "left")
    )
    (flyingsnowball
      (x 2754)
      (y 249)
      (sprite "images/creatures/flying_snowball/flying_snowball.sprite")
      (direction "left")
    )
    (flyingsnowball
      (x 2655)
      (y 213)
      (sprite "images/creatures/flying_snowball/flying_snowball.sprite")
      (direction "left")
    )
    (flame
      (x 2659)
      (y 222)
      (sprite "images/creatures/flame/flame.sprite")
      (direction "left")
    )
    (stalactite
      (x 2464)
      (y 1)
      (sprite "images/creatures/stalactite/stalactite.sprite")
      (direction "left")
    )
    (mrbomb
      (x 2463)
      (y 222)
      (sprite "images/creatures/mr_bomb/mr_bomb.sprite")
      (direction "left")
    )
    (mrbomb
      (x 2368)
      (y 285)
      (sprite "images/creatures/mr_bomb/mr_bomb.sprite")
      (direction "left")
    )
    (mrbomb
      (x 2272)
      (y 320)
      (sprite "images/creatures/mr_bomb/mr_bomb.sprite")
      (direction "left")
    )
    (stalactite
      (x 2275)
      (y 2)
      (sprite "images/creatures/stalactite/stalactite.sprite")
      (direction "left")
    )
    (stalactite
      (x 2369)
      (y 5)
      (sprite "images/creatures/stalactite/stalactite.sprite")
      (direction "left")
    )
    (stalactite
      (x 2561)
      (y 3)
      (sprite "images/creatures/stalactite/stalactite.sprite")
      (direction "left")
    )
    (fish
      (x 1765)
      (y 422)
      (sprite "images/creatures/fish/fish.sprite")
      (direction "left")
    )
    (fish
      (x 1815)
      (y 421)
      (sprite "images/creatures/fish/fish.sprite")
      (direction "left")
    )
    (fish
      (x 1878)
      (y 413)
      (sprite "images/creatures/fish/fish.sprite")
      (direction "left")
    )
    (jumpy
      (x 1988)
      (y 355)
      (sprite "images/creatures/snowjumpy/snowjumpy.sprite")
      (direction "left")
    )
    (jumpy
      (x 2084)
      (y 352)
      (sprite "images/creatures/snowjumpy/snowjumpy.sprite")
      (direction "left")
    )
    (jumpy
      (x 2180)
      (y 350)
      (sprite "images/creatures/snowjumpy/snowjumpy.sprite")
      (direction "left")
    )
    (jumpy
      (x 2606)
      (y 401)
      (sprite "images/creatures/snowjumpy/snowjumpy.sprite")
      (direction "left")
    )
    (jumpy
      (x 2606)
      (y 395)
      (sprite "images/creatures/snowjumpy/snowjumpy.sprite")
      (direction "left")
    )
    (jumpy
      (x 2606)
      (y 389)
      (sprite "images/creatures/snowjumpy/snowjumpy.sprite")
      (direction "left")
    )
    (jumpy
      (x 2605)
      (y 381)
      (sprite "images/creatures/snowjumpy/snowjumpy.sprite")
      (direction "left")
    )
    (jumpy
      (x 2605)
      (y 380)
      (sprite "images/creatures/snowjumpy/snowjumpy.sprite")
      (direction "left")
    )
    (jumpy
      (x 2605)
      (y 369)
      (sprite "images/creatures/snowjumpy/snowjumpy.sprite")
      (direction "left")
    )
    (jumpy
      (x 2508)
      (y 403)
      (sprite "images/creatures/snowjumpy/snowjumpy.sprite")
      (direction "left")
    )
    (jumpy
      (x 2508)
      (y 397)
      (sprite "images/creatures/snowjumpy/snowjumpy.sprite")
      (direction "left")
    )
    (jumpy
      (x 2508)
      (y 393)
      (sprite "images/creatures/snowjumpy/snowjumpy.sprite")
      (direction "left")
    )
    (jumpy
      (x 2508)
      (y 382)
      (sprite "images/creatures/snowjumpy/snowjumpy.sprite")
      (direction "left")
    )
    (jumpy
      (x 2508)
      (y 377)
      (sprite "images/creatures/snowjumpy/snowjumpy.sprite")
      (direction "left")
    )
    (jumpy
      (x 2508)
      (y 368)
      (sprite "images/creatures/snowjumpy/snowjumpy.sprite")
      (direction "left")
    )
    (jumpy
      (x 2508)
      (y 361)
      (sprite "images/creatures/snowjumpy/snowjumpy.sprite")
      (direction "left")
    )
    (mrbomb
      (x 2798)
      (y 411)
      (sprite "images/creatures/mr_bomb/mr_bomb.sprite")
      (direction "left")
    )
    (camera
      (name "Camera")
      (mode "normal")
    )
  )
)
