(supertux-level
  (version 2)
  (name (_ "Unnamed"))
  (author "Hume2")
  (contact "Nemám zájem, aby mě někdo otravoval.")
  (license "CC-BY-SA 4.0")
  (target-time 0)
  (sector
    (name "main")
    (ambient-light 1 1 1)
    (camera
      (mode "normal")
    )
    (teleporter
      (spawnpoint "tele2-")
      (message (_ "Warp to the EIA2 World"))
      (sprite "images/worldmap/common/teleporterdot.sprite")
      (x 8)
      (y 10)
    )
    (teleporter
      (spawnpoint "tele2+")
      (message (_ "Leave the EIA2 World"))
      (sprite "images/worldmap/common/teleporterdot.sprite")
      (x 10)
      (y 16)
    )
    (teleporter
      (spawnpoint "tele4-")
      (message (_ "Warp to the EIA4 World"))
      (sprite "images/worldmap/common/teleporterdot.sprite")
      (x 14)
      (y 10)
    )
    (teleporter
      (spawnpoint "tele4+")
      (message (_ "Leave the EIA4 World"))
      (sprite "images/worldmap/common/teleporterdot.sprite")
      (x 39)
      (y 11)
    )
    (tilemap
      (solid #t)
      (z-pos -100)
      (name "Background")
      (width 50)
      (height 40)
      (tiles
      0 0 0 0 0 0 0 0 0 0 0 0 0 0 0 0 0 0 0 0 0 0 0 0 0 0 0 0 0 0 0 0 0 0 0 0 0 0 0 0 0 0 0 0 0 0 0 0 0 0
      0 0 0 0 0 0 0 0 0 0 0 0 0 0 0 0 0 0 0 0 0 0 0 0 0 0 0 0 0 0 0 0 0 0 0 0 0 0 0 0 0 0 0 0 0 0 0 0 0 0
      0 0 0 101 102 102 102 102 102 102 102 102 103 0 0 0 0 0 0 0 0 0 0 0 0 0 0 0 0 0 0 0 0 0 0 0 0 0 0 0 0 0 0 0 0 0 0 0 0 0
      0 0 0 104 105 105 105 105 105 105 105 105 106 0 0 0 0 0 0 0 0 0 0 0 0 0 0 0 0 0 0 0 0 0 0 0 0 0 0 0 0 0 0 0 0 0 0 0 0 0
      0 0 0 104 105 105 115 105 105 105 105 105 106 0 0 0 0 0 0 0 0 0 0 0 0 0 0 0 0 0 0 0 0 0 0 0 0 0 0 0 0 0 0 0 0 0 0 0 0 0
      0 0 0 104 105 105 116 105 105 105 105 114 106 0 0 0 0 0 0 0 0 0 0 0 0 0 0 0 0 0 0 0 0 0 0 0 0 0 0 0 0 0 0 0 0 0 0 0 0 0
      0 0 0 104 114 105 105 105 105 105 105 105 112 102 102 102 102 103 0 0 0 0 0 0 0 0 0 0 0 0 0 0 0 0 0 0 0 0 0 0 0 0 0 0 0 0 0 0 0 0
      0 0 0 104 105 105 105 105 105 105 105 105 105 105 105 105 105 106 0 0 0 0 0 0 0 0 0 0 0 0 0 0 0 0 0 0 0 0 0 0 0 0 0 0 0 0 0 0 0 0
      0 0 0 104 105 105 105 105 105 105 105 105 105 105 105 105 105 106 0 0 0 0 0 0 0 0 0 0 0 0 0 0 0 101 102 102 102 102 102 102 102 102 102 102 102 103 0 0 0 0
      0 0 0 104 105 105 105 105 105 105 105 105 105 105 105 105 105 106 0 0 0 0 0 0 0 0 0 0 0 101 102 102 102 113 105 105 105 105 105 105 105 105 114 105 105 106 0 0 0 0
      0 0 0 104 105 105 105 105 105 105 105 105 105 105 105 105 105 106 0 0 0 0 0 0 0 0 0 0 0 104 105 105 105 105 105 105 105 105 105 115 105 105 105 105 105 112 103 0 0 0
      0 0 0 104 105 105 105 105 114 105 105 105 105 105 114 105 105 106 0 0 0 0 0 0 0 0 0 0 101 113 105 105 105 105 105 105 105 105 105 116 105 105 105 105 105 105 106 0 0 0
      0 0 0 107 108 108 108 108 108 108 108 108 108 108 108 108 108 109 0 0 0 0 0 0 0 0 0 0 104 105 105 105 105 105 105 105 105 105 105 105 105 105 105 105 105 105 106 0 0 0
      0 0 0 0 0 0 0 0 0 0 0 0 0 0 0 0 0 0 0 0 0 0 0 0 0 0 0 0 104 105 105 105 105 105 105 105 105 105 105 105 105 105 105 105 105 105 106 0 0 0
      0 0 0 0 0 0 0 0 0 101 102 103 0 0 0 0 0 0 0 0 0 0 0 0 0 0 0 0 104 105 105 33 105 105 105 105 105 105 105 105 114 105 105 105 105 110 109 0 0 0
      0 0 0 0 0 0 0 0 0 104 115 106 0 0 0 0 0 0 0 0 0 0 0 0 0 0 0 0 104 105 105 105 105 105 105 105 105 105 105 105 105 105 105 105 105 106 0 0 0 0
      0 0 0 0 0 0 0 0 0 104 116 106 0 0 0 0 0 0 0 0 0 0 0 0 0 0 0 215 104 105 105 105 105 105 105 105 105 105 105 105 105 105 105 105 110 109 0 0 0 0
      0 0 0 0 0 0 0 0 0 107 108 109 0 0 0 0 0 0 0 0 0 0 0 0 0 0 0 208 104 105 105 105 105 105 105 105 105 105 105 105 105 110 108 108 109 0 0 0 0 0
      0 0 0 0 0 0 0 0 0 0 0 0 0 0 0 0 0 0 0 0 0 0 0 0 0 0 0 208 104 105 105 105 105 105 105 105 105 105 105 105 110 109 0 0 0 0 0 0 0 0
      0 0 0 0 0 0 0 0 0 0 0 0 0 0 0 0 0 0 0 0 0 0 0 0 0 0 0 208 104 105 105 114 105 105 105 105 105 105 110 108 109 0 0 0 0 0 0 0 0 0
      0 0 0 0 0 0 101 102 102 102 102 102 102 102 102 102 102 102 102 102 102 102 103 0 0 0 0 208 104 105 105 105 105 105 105 105 105 105 112 103 0 0 0 0 0 0 0 0 0 0
      0 0 0 0 0 0 104 105 105 105 105 105 105 105 105 105 105 105 105 105 105 105 106 0 0 0 0 208 104 105 105 105 105 105 105 105 105 105 105 112 102 103 0 0 0 0 0 0 0 0
      0 0 0 0 0 101 113 105 105 105 110 108 108 108 111 105 105 105 105 105 105 105 106 0 0 0 0 208 104 105 105 105 30 105 43 105 105 105 105 105 105 112 102 102 103 0 0 0 0 0
      0 0 0 0 0 104 105 105 105 105 106 0 0 0 104 105 105 105 105 105 105 105 106 0 0 0 0 208 104 105 105 105 35 105 105 105 105 105 105 105 105 105 105 105 112 102 103 0 0 0
      0 0 0 0 0 104 105 105 114 105 112 103 0 0 104 105 105 105 105 105 105 105 106 0 0 0 0 208 104 105 105 105 105 105 105 105 105 105 105 114 105 105 105 114 105 105 106 0 0 0
      0 0 0 0 0 104 105 105 105 105 105 112 102 102 113 105 105 105 105 105 105 114 106 0 0 0 0 211 104 105 105 105 105 105 105 105 105 105 105 105 105 105 105 105 105 105 106 0 0 0
      0 0 0 0 0 104 105 105 105 105 105 105 105 105 105 105 105 105 105 105 105 105 106 0 0 0 0 0 104 105 105 105 105 105 105 105 105 105 105 105 105 105 105 105 110 108 109 0 0 0
      0 0 0 0 0 104 105 105 105 105 105 105 105 105 105 105 105 105 110 108 108 108 109 0 0 0 0 0 104 105 105 105 105 105 105 105 105 105 105 105 105 105 105 105 106 0 0 0 0 0
      0 0 0 0 0 104 105 105 38 40 40 40 40 40 40 37 105 105 106 0 0 0 0 0 0 0 0 0 107 111 105 105 105 105 105 105 105 105 105 105 105 105 105 105 106 0 0 0 0 0
      0 0 0 0 0 104 105 105 105 105 105 105 105 105 105 105 105 105 106 0 0 0 0 0 0 0 0 0 0 107 111 105 105 105 105 105 105 105 105 105 105 105 105 105 112 103 0 0 0 0
      0 0 0 0 0 107 111 105 105 105 105 105 105 105 105 105 105 105 106 0 0 0 0 0 0 0 0 0 0 0 107 108 111 105 105 105 105 105 105 105 105 105 105 105 105 112 103 0 0 0
      0 0 0 0 0 0 107 108 108 108 111 105 105 105 105 105 105 105 106 0 0 0 0 0 0 0 0 0 0 0 0 0 107 108 111 105 105 105 105 105 105 105 105 105 105 105 106 0 0 0
      0 0 0 0 0 0 0 0 0 0 104 105 105 114 105 105 105 110 109 0 0 0 0 0 0 0 0 0 0 0 0 0 0 0 107 108 111 105 114 105 105 105 105 105 105 105 106 0 0 0
      0 0 0 0 0 0 0 0 0 0 104 114 105 105 110 108 108 109 0 0 0 0 0 0 0 0 0 0 0 0 0 0 0 101 102 102 113 105 105 105 105 105 105 105 105 105 106 0 0 0
      0 0 0 0 0 0 0 0 0 101 113 105 105 105 106 0 0 0 101 102 102 102 102 103 0 0 0 0 101 102 102 102 102 113 105 105 105 105 105 105 105 105 105 105 114 105 106 0 0 0
      0 0 0 0 0 0 0 101 102 113 105 105 105 105 106 0 0 0 104 105 60 61 62 106 0 0 0 101 113 105 105 105 105 105 105 105 105 105 105 105 105 105 105 105 105 110 109 0 0 0
      0 0 0 0 0 0 0 104 105 105 105 105 105 105 106 0 0 0 104 105 63 64 65 106 0 0 0 104 105 105 105 105 105 105 105 105 105 105 105 105 105 105 105 105 105 106 0 0 0 0
      0 0 0 0 0 0 101 113 105 105 105 105 105 105 106 0 0 0 104 105 20 15 68 106 0 0 0 104 105 14 20 105 105 105 105 105 105 105 105 105 105 105 105 110 108 109 0 0 0 0
      0 0 0 0 0 0 104 105 105 105 105 105 105 105 106 0 0 0 107 108 108 108 108 109 0 0 0 107 108 111 105 105 105 105 105 105 105 105 105 110 108 108 108 109 0 0 0 0 0 0
      0 0 0 0 0 0 107 108 108 108 108 108 108 108 109 0 0 0 0 0 0 0 0 0 0 0 0 0 0 107 108 108 108 108 108 108 108 108 108 109 0 0 0 0 0 0 0 0 0 0
      )
    )
    (tilemap
      (solid #t)
      (z-pos 0)
      (name "Interactive")
      (width 50)
      (height 40)
      (tiles
      0 0 0 0 0 0 0 0 0 0 0 0 0 0 0 0 0 0 0 0 0 0 0 0 0 0 0 0 0 0 0 0 0 0 0 0 0 0 0 0 0 0 0 0 0 0 0 0 0 0
      0 0 0 0 0 0 0 0 0 0 0 0 0 0 0 0 0 0 0 0 0 204 206 0 0 0 0 0 0 0 0 0 0 0 0 0 0 0 0 0 0 0 0 0 0 0 0 0 0 0
      0 0 0 0 136 137 137 138 0 0 0 0 0 0 0 0 0 0 0 0 0 210 212 0 0 0 0 0 204 206 0 0 0 0 0 0 0 0 0 0 0 0 0 0 0 0 0 0 0 0
      0 0 0 0 139 140 145 144 0 0 0 0 0 0 0 0 0 0 0 0 218 0 0 0 0 218 0 0 210 212 0 0 0 0 0 0 0 0 0 0 0 0 0 0 0 0 0 0 0 0
      0 0 0 0 142 143 144 0 0 0 0 0 0 0 0 0 0 0 0 0 0 0 0 0 0 0 0 0 0 0 0 0 0 0 0 0 0 0 0 0 0 0 0 0 0 0 0 0 0 0
      0 0 0 0 0 0 0 0 0 0 0 0 0 0 0 0 0 0 0 0 0 218 0 0 0 0 0 218 0 0 0 0 0 0 0 0 0 0 0 0 0 0 0 0 0 0 0 0 0 0
      0 0 0 0 0 0 21 0 0 0 0 0 136 137 138 0 0 0 0 0 0 0 0 0 0 0 0 0 0 0 0 0 0 0 0 0 0 0 0 0 0 0 0 0 0 0 0 0 0 0
      0 0 0 0 0 0 14 20 20 20 20 11 139 140 147 138 0 0 0 218 0 0 204 205 205 206 0 0 0 0 0 0 0 0 0 0 0 0 0 0 0 0 0 0 0 0 0 0 0 0
      0 0 0 0 0 0 0 0 0 0 0 21 142 146 140 141 0 0 0 0 0 0 207 208 208 215 206 0 0 0 0 0 0 0 171 179 136 137 138 171 179 0 0 0 0 0 0 0 0 0
      0 0 0 136 148 140 140 145 143 144 0 21 0 142 143 144 0 0 0 0 0 204 216 208 217 208 209 0 0 0 136 137 138 0 172 180 142 143 144 172 180 0 0 171 179 0 0 0 0 0
      0 0 0 139 140 140 140 141 18 20 20 16 20 20 23 0 0 0 0 0 0 207 208 217 208 208 209 0 0 0 142 143 144 0 0 0 0 0 0 0 136 137 138 172 180 0 0 0 0 0
      0 0 0 142 143 143 143 144 0 0 0 0 0 0 0 0 0 0 0 0 204 216 208 208 208 208 209 0 0 0 136 138 0 0 0 0 0 0 0 0 142 143 144 0 136 137 138 0 0 0
      0 0 0 0 0 0 0 0 0 0 0 0 0 0 0 0 0 0 0 0 207 208 208 208 208 213 212 0 0 136 148 147 137 137 137 137 137 138 0 21 0 171 173 175 142 143 144 0 0 0
      0 0 0 0 0 0 0 0 0 0 0 0 0 0 0 0 0 0 204 205 216 208 208 208 208 215 206 0 0 142 143 143 143 143 143 143 143 144 0 21 0 172 174 176 178 180 0 0 0 0
      0 0 0 0 0 0 0 0 0 0 0 0 0 0 0 204 205 205 216 208 208 208 208 217 208 208 209 0 0 0 30 10 20 20 20 20 20 20 20 15 0 136 137 138 0 0 0 0 0 0
      0 0 0 0 0 0 0 0 0 0 0 0 0 204 205 216 208 208 217 208 208 208 208 208 208 208 215 206 0 0 41 21 0 0 0 0 0 0 0 137 137 148 140 141 0 0 0 0 0 0
      0 0 0 0 0 0 0 0 0 0 0 0 0 207 208 208 208 208 208 208 208 208 208 208 208 208 208 0 0 0 41 21 0 146 0 0 140 0 145 143 143 143 143 144 0 0 0 0 0 0
      0 0 0 0 0 0 0 0 0 0 49 0 0 210 211 211 211 211 214 208 208 208 208 208 208 208 208 30 40 40 35 21 0 142 143 143 143 143 144 0 0 0 0 0 0 0 0 0 0 0
      0 0 0 0 0 0 0 0 0 0 50 0 0 0 0 0 0 0 210 211 211 214 208 208 208 208 208 41 0 0 0 14 20 20 20 20 20 11 0 0 0 0 0 0 0 0 0 0 0 0
      0 0 0 0 0 0 0 0 0 0 50 0 0 0 0 0 0 0 0 0 0 210 211 214 208 208 208 41 0 0 0 0 0 136 137 138 0 21 0 0 0 0 0 0 0 0 0 0 0 0
      0 0 0 0 0 0 0 0 0 0 51 0 0 0 0 0 0 0 0 136 137 138 0 207 208 208 208 41 0 136 137 137 137 148 140 141 0 21 0 0 0 0 0 0 0 0 0 0 0 0
      0 0 0 0 0 0 0 10 20 20 15 0 0 0 0 0 0 0 0 139 140 141 0 210 214 217 208 41 0 139 140 145 143 143 143 144 0 21 0 0 0 0 0 0 0 0 0 0 0 0
      0 0 0 0 0 0 0 21 0 0 0 0 0 0 0 0 0 0 0 142 143 144 0 0 207 208 208 41 0 142 143 144 0 40 0 0 170 21 0 0 0 0 0 0 0 0 0 0 0 0
      0 0 0 0 0 0 0 14 20 20 46 47 47 47 48 20 20 20 20 20 11 0 0 0 210 214 208 34 0 40 40 40 0 0 139 140 141 14 20 20 20 11 0 0 0 0 0 0 0 0
      0 0 0 0 0 0 0 0 0 0 0 0 0 0 0 0 0 0 0 0 21 0 0 0 0 207 208 0 0 0 0 0 0 0 142 143 144 0 0 0 0 21 0 0 0 0 0 0 0 0
      0 0 0 0 0 0 0 181 184 187 0 0 0 0 0 142 143 143 143 144 21 0 0 0 0 210 211 0 0 172 183 186 189 180 0 0 0 0 0 0 0 21 0 0 0 0 0 0 0 0
      0 0 0 0 0 0 171 182 185 188 179 0 0 0 0 10 20 20 20 20 15 0 0 0 0 0 0 0 0 0 10 20 20 20 20 20 20 20 20 20 20 15 0 0 0 0 0 0 0 0
      0 0 0 0 0 0 172 183 186 189 180 184 187 0 0 21 0 0 0 0 0 0 0 0 0 0 0 0 0 0 21 0 0 0 172 183 186 189 180 0 0 0 0 0 0 0 0 0 0 0
      0 0 0 0 0 0 171 173 175 177 182 185 188 179 0 21 0 0 0 0 0 0 0 0 0 0 0 0 0 0 14 20 20 11 0 0 0 0 0 0 0 0 0 0 0 0 0 0 0 0
      0 0 0 0 0 0 172 174 176 178 183 186 189 180 0 21 0 0 0 0 0 0 0 0 0 0 0 0 0 0 0 0 0 21 172 174 176 178 183 186 189 183 186 189 180 0 0 0 0 0
      0 0 0 0 0 0 0 0 10 20 20 20 20 20 20 15 0 0 0 0 0 0 0 0 0 0 0 0 0 0 0 0 0 14 20 20 20 20 20 20 20 20 11 171 179 0 0 0 0 0
      0 0 0 0 0 0 0 0 49 0 0 0 0 0 0 0 0 0 0 0 0 0 0 0 0 0 0 0 0 0 0 0 0 0 0 0 0 0 0 0 0 0 21 172 180 0 0 0 0 0
      0 0 0 0 0 0 0 0 50 0 0 0 0 0 0 0 0 0 0 0 0 0 0 0 0 0 0 0 0 0 0 0 0 0 0 0 0 0 0 0 0 170 21 0 171 179 0 0 0 0
      0 0 0 0 0 0 0 0 50 0 0 0 0 0 0 0 0 0 0 0 0 0 0 0 0 0 0 0 0 0 0 0 0 0 0 0 0 171 173 175 177 179 21 0 172 180 0 0 0 0
      0 0 0 0 0 0 0 0 50 0 181 184 187 0 0 0 0 0 136 137 138 0 0 0 0 0 0 0 0 170 170 170 181 184 187 181 184 172 174 176 178 180 21 0 0 0 0 0 0 0
      0 0 0 0 0 0 0 0 51 171 182 185 188 179 0 0 0 0 142 146 141 0 0 0 0 0 0 0 60 61 62 171 182 185 188 182 185 188 179 0 0 0 21 0 0 0 0 0 0 0
      0 0 0 0 0 0 0 0 21 172 183 186 189 180 0 0 0 0 0 142 144 0 0 0 0 0 0 0 63 64 65 172 183 186 189 183 186 189 180 10 20 20 15 0 0 0 0 0 0 0
      0 0 0 0 0 0 0 0 14 20 20 20 20 20 46 47 47 47 48 20 66 67 0 0 0 0 0 0 66 67 68 20 20 20 20 20 20 20 20 15 0 0 0 0 0 0 0 0 0 0
      0 0 0 0 0 0 0 0 0 0 0 0 0 0 0 0 0 0 0 0 0 0 0 0 0 0 0 0 0 0 0 0 0 0 0 0 0 0 0 0 0 0 0 0 0 0 0 0 0 0
      0 0 0 0 0 0 0 0 0 0 0 0 0 0 0 0 0 0 0 0 0 0 0 0 0 0 0 0 0 0 0 0 0 0 0 0 0 0 0 0 0 0 0 0 0 0 0 0 0 0
      )
    )
    (tilemap
      (solid #t)
      (z-pos 100)
      (name "Foreground")
      (width 50)
      (height 40)
      (tiles
      0 0 0 0 0 0 0 0 0 0 0 0 0 0 0 0 0 0 0 0 0 0 0 0 0 0 0 0 0 0 0 0 0 0 0 0 0 0 0 0 0 0 0 0 0 0 0 0 0 0
      0 0 0 0 0 0 0 0 0 0 0 0 0 0 0 0 0 0 0 0 0 0 0 0 0 0 0 0 0 0 0 0 0 0 0 0 0 0 0 0 0 0 0 0 0 0 0 0 0 0
      0 0 0 0 0 0 0 0 0 0 0 0 0 0 0 0 0 0 0 0 0 0 0 0 0 0 0 0 0 0 0 0 0 0 0 0 0 0 0 0 0 0 0 0 0 0 0 0 0 0
      0 0 0 0 0 0 0 0 136 137 137 138 0 0 0 0 0 0 0 0 0 0 0 0 0 0 0 0 0 0 0 0 0 0 0 0 0 0 0 0 0 0 0 0 0 0 0 0 0 0
      0 0 0 0 0 0 0 0 139 140 145 144 0 0 0 0 0 0 0 0 0 0 0 0 0 0 0 0 0 0 0 0 0 0 0 0 0 0 0 0 0 0 0 0 0 0 0 0 0 0
      0 0 0 0 0 0 0 0 142 143 144 0 0 0 0 0 0 0 0 0 0 0 0 0 0 0 0 0 0 0 0 0 0 0 0 0 0 0 0 0 0 0 0 0 0 0 0 0 0 0
      0 0 0 0 0 0 0 0 0 0 0 0 0 0 0 0 0 0 0 0 0 0 0 0 0 0 0 0 0 0 0 0 0 0 0 0 0 0 0 0 0 0 0 0 0 0 0 0 0 0
      0 0 0 0 136 137 137 137 137 137 138 0 0 0 0 0 0 0 0 0 0 0 0 0 0 0 0 0 0 0 0 0 0 0 0 0 0 0 0 0 0 0 0 0 0 0 0 0 0 0
      0 0 0 0 139 140 140 140 140 145 144 0 0 0 0 0 0 0 0 0 0 0 0 0 0 0 0 0 0 0 0 0 0 0 0 0 0 0 0 0 0 0 0 0 0 0 0 0 0 0
      0 0 0 0 0 0 0 0 0 0 0 0 0 0 0 0 0 0 0 0 0 0 0 0 0 0 0 0 0 0 0 0 0 0 0 0 0 0 0 0 0 0 0 0 0 0 0 0 0 0
      0 0 0 0 0 0 0 0 0 0 0 0 0 0 0 0 0 0 0 0 0 0 0 0 0 0 0 0 0 0 0 0 0 171 173 175 177 179 0 0 0 0 0 0 0 0 0 0 0 0
      0 0 0 0 0 0 0 0 0 0 0 0 0 0 0 0 0 0 0 0 0 0 0 0 0 0 0 0 0 0 0 0 0 172 174 176 178 180 0 0 0 0 0 0 0 0 0 0 0 0
      0 0 0 0 0 0 0 0 0 0 0 0 0 0 0 0 0 0 0 0 0 0 0 0 0 0 0 0 0 0 0 0 0 0 0 0 0 0 0 0 0 0 0 0 177 179 0 0 0 0
      0 0 0 0 0 0 0 0 0 0 0 0 0 0 0 0 0 0 0 0 0 0 0 0 0 0 0 0 0 0 0 0 0 0 0 0 0 0 0 0 0 0 0 0 0 0 0 0 0 0
      0 0 0 0 0 0 0 0 0 0 0 0 0 0 0 0 0 0 0 0 0 0 0 0 0 0 0 0 0 0 0 0 136 137 138 136 137 137 138 0 0 0 0 0 0 0 0 0 0 0
      0 0 0 0 0 0 0 0 0 0 0 0 0 0 0 0 0 0 0 0 0 0 0 0 0 0 0 0 0 0 0 0 139 140 141 139 140 140 147 0 0 0 0 0 0 0 0 0 0 0
      0 0 0 0 0 0 0 0 0 0 0 0 0 0 0 0 0 0 0 0 0 0 0 0 0 0 0 0 0 0 0 0 142 0 147 148 0 140 0 0 0 0 0 0 0 0 0 0 0 0
      0 0 0 0 0 0 0 0 0 0 0 0 0 0 0 0 0 0 0 0 0 0 0 0 0 0 0 0 0 0 0 0 0 0 0 0 0 0 0 0 0 0 0 0 0 0 0 0 0 0
      0 0 0 0 0 0 0 0 0 0 0 0 0 0 0 0 0 0 0 0 0 0 0 0 0 0 0 0 0 0 0 0 0 0 0 0 0 0 0 0 0 0 0 0 0 0 0 0 0 0
      0 0 0 0 0 0 0 0 0 0 0 0 181 184 187 0 0 0 0 0 0 0 0 0 0 0 0 0 0 0 0 0 0 0 0 0 0 0 0 0 0 0 0 0 0 0 0 0 0 0
      0 0 0 0 0 0 0 0 0 0 0 171 182 185 188 173 175 177 179 0 0 0 0 0 0 0 0 0 0 0 0 0 0 0 0 0 0 0 0 0 0 0 0 0 0 0 0 0 0 0
      0 0 0 0 0 0 0 0 0 0 0 172 183 186 189 174 176 178 180 0 0 0 0 0 0 0 0 0 0 0 0 0 0 0 0 170 0 0 0 0 0 0 0 0 0 0 0 0 0 0
      0 0 0 0 0 0 0 0 0 0 0 0 0 0 0 0 0 0 0 0 0 0 0 0 0 0 0 0 0 0 0 0 0 0 136 137 138 0 0 0 0 0 0 0 0 0 0 0 0 0
      0 0 0 0 0 0 0 0 0 0 0 0 0 0 0 136 137 137 137 138 0 0 0 0 0 0 0 0 40 0 181 184 187 0 0 0 0 0 0 0 0 0 0 0 0 0 0 0 0 0
      0 0 0 0 0 0 0 0 0 0 0 0 0 0 0 139 140 140 140 141 0 0 0 0 0 0 0 0 0 171 182 185 188 179 0 0 0 0 0 0 0 0 0 0 0 0 0 0 0 0
      0 0 0 0 0 0 0 0 0 0 0 0 0 0 0 0 0 0 0 0 0 0 0 0 0 0 0 0 0 0 0 0 0 0 0 181 184 187 0 0 0 0 0 0 0 170 0 0 0 0
      0 0 0 0 0 0 0 0 0 0 0 0 0 0 0 0 0 0 0 0 0 0 0 0 0 0 0 0 0 0 0 0 0 0 171 182 185 188 179 0 0 0 0 170 0 0 0 0 0 0
      0 0 0 0 0 0 0 0 0 0 181 184 187 0 0 0 0 0 0 0 0 0 0 0 0 0 0 0 0 0 0 0 0 0 0 0 0 0 181 184 187 181 184 187 0 0 0 0 0 0
      0 0 0 0 0 0 0 173 175 177 182 185 188 179 0 0 0 0 0 0 0 0 0 0 0 0 0 0 0 0 0 0 0 0 171 173 175 177 182 185 188 182 185 188 179 0 0 0 0 0
      0 0 0 0 0 0 0 0 0 0 0 0 0 0 181 184 187 0 0 0 0 0 0 0 0 0 0 0 0 0 0 0 0 0 0 0 0 181 184 187 0 0 0 0 0 0 0 0 0 0
      0 0 0 0 0 0 0 0 0 0 0 0 0 171 182 185 188 179 0 0 0 0 0 0 0 0 0 0 0 0 0 0 0 0 0 0 171 182 185 188 179 0 0 0 0 0 0 0 0 0
      0 0 0 0 0 0 0 0 0 0 0 0 0 172 183 186 189 180 0 0 0 0 0 0 0 0 0 0 0 0 0 0 0 0 0 0 172 183 186 189 180 0 0 0 0 0 0 0 0 0
      0 0 0 0 0 0 0 0 0 0 0 0 0 0 0 0 0 0 0 0 0 0 0 0 0 0 0 0 0 0 0 0 0 0 0 0 0 0 0 0 0 0 0 0 0 0 0 0 0 0
      0 0 0 0 0 0 0 0 0 0 0 0 0 0 0 0 0 0 0 0 0 0 0 0 0 0 0 0 0 0 0 0 0 0 0 0 0 0 0 0 0 0 0 0 0 0 0 0 0 0
      0 0 0 0 0 0 0 0 0 0 0 0 0 0 0 0 0 0 0 0 0 0 0 0 0 0 0 0 0 0 0 0 0 0 0 0 0 187 0 0 0 0 0 0 0 0 0 0 0 0
      0 0 0 0 0 0 0 0 0 0 0 0 0 0 0 0 0 0 0 0 0 0 0 0 0 0 0 0 0 0 0 0 0 0 0 0 0 0 0 0 0 0 0 0 0 0 0 0 0 0
      0 0 0 0 0 0 0 0 0 0 0 0 0 0 0 0 0 0 0 0 0 0 0 0 0 0 0 0 0 0 0 0 0 0 0 0 0 0 0 0 0 0 0 0 0 0 0 0 0 0
      0 0 0 0 0 0 0 171 173 175 177 179 0 0 0 0 0 0 0 0 0 0 0 0 0 0 0 0 0 0 0 0 0 0 171 173 175 177 179 0 0 170 0 0 0 0 0 0 0 0
      0 0 0 0 0 0 0 172 174 176 178 180 0 0 0 0 0 0 0 0 0 0 0 0 0 0 0 0 0 0 0 0 170 0 172 174 176 178 180 0 0 0 0 0 0 0 0 0 0 0
      0 0 0 0 0 0 0 0 0 0 0 0 0 0 0 0 0 0 0 0 0 0 0 0 0 0 0 0 0 0 0 0 0 0 0 0 0 0 0 0 0 0 0 0 0 0 0 0 0 0
      )
    )
    (tilemap
      (solid #f)
      (z-pos -102)
      (name "vodka")
      (width 50)
      (height 40)
      (tiles
      1 1 1 1 1 1 1 1 1 1 1 1 1 1 1 1 1 1 1 1 1 1 1 1 1 1 1 1 1 1 1 1 1 1 1 1 1 1 1 1 1 1 1 1 1 1 1 1 1 1
      1 1 1 1 1 1 1 1 1 1 1 1 1 1 1 1 1 1 1 1 1 1 1 1 1 1 1 1 1 1 1 1 1 1 1 1 1 1 1 1 1 1 1 1 1 1 1 1 1 1
      1 1 1 1 1 1 1 1 1 1 1 1 1 1 1 1 1 1 1 1 1 1 1 1 1 1 1 1 1 1 1 1 1 1 1 1 1 1 1 1 1 1 1 1 1 1 1 1 1 1
      1 1 1 1 1 1 1 1 1 1 1 1 1 1 1 1 1 1 1 1 1 1 1 1 1 1 1 1 1 1 1 1 1 1 1 1 1 1 1 1 1 1 1 1 1 1 1 1 1 1
      1 1 1 1 1 1 1 1 1 1 1 1 1 1 1 1 1 1 1 1 1 1 1 1 1 1 1 1 1 1 1 1 1 1 1 1 1 1 1 1 1 1 1 1 1 1 1 1 1 1
      1 1 1 1 1 1 1 1 1 1 1 1 1 1 1 1 1 1 1 1 1 1 1 1 1 1 1 1 1 1 1 1 1 1 1 1 1 1 1 1 1 1 1 1 1 1 1 1 1 1
      1 1 1 1 1 1 1 1 1 1 1 1 1 1 1 1 1 1 1 1 1 1 1 1 1 1 1 1 1 1 1 1 1 1 1 1 1 1 1 1 1 1 1 1 1 1 1 1 1 1
      1 1 1 1 1 1 1 1 1 1 1 1 1 1 1 1 1 1 1 1 1 1 1 1 1 1 1 1 1 1 1 1 1 1 1 1 1 1 1 1 1 1 1 1 1 1 1 1 1 1
      1 1 1 1 1 1 1 1 1 1 1 1 1 1 1 1 1 1 1 1 1 1 1 1 1 1 1 1 1 1 1 1 1 1 1 1 1 1 1 1 1 1 1 1 1 1 1 1 1 1
      1 1 1 1 1 1 1 1 1 1 1 1 1 1 1 1 1 1 1 1 1 1 1 1 1 1 1 1 1 1 1 1 1 1 1 1 1 1 1 1 1 1 1 1 1 1 1 1 1 1
      1 1 1 1 1 1 1 1 1 1 1 1 1 1 1 1 1 1 1 1 1 1 1 1 1 1 1 1 1 1 1 1 1 1 1 1 1 1 1 1 1 1 1 1 1 1 1 1 1 1
      1 1 1 1 1 1 1 1 1 1 1 1 1 1 1 1 1 1 1 1 1 1 1 1 1 1 1 1 1 1 1 1 1 1 1 1 1 1 1 1 1 1 1 1 1 1 1 1 1 1
      1 1 1 1 1 1 1 1 1 1 1 1 1 1 1 1 1 1 1 1 1 1 1 1 1 1 1 1 1 1 1 1 1 1 1 1 1 1 1 1 1 1 1 1 1 1 1 1 1 1
      1 1 1 1 1 1 1 1 1 1 1 1 1 1 1 1 1 1 1 1 1 1 1 1 1 1 1 1 1 1 1 1 1 1 1 1 1 1 1 1 1 1 1 1 1 1 1 1 1 1
      1 1 1 1 1 1 1 1 1 1 1 1 1 1 1 1 1 1 1 1 1 1 1 1 1 1 1 1 1 1 1 1 1 1 1 1 1 1 1 1 1 1 1 1 1 1 1 1 1 1
      1 1 1 1 1 1 1 1 1 1 1 1 1 1 1 1 1 1 1 1 1 1 1 1 1 1 1 1 1 1 1 1 1 1 1 1 1 1 1 1 1 1 1 1 1 1 1 1 1 1
      1 1 1 1 1 1 1 1 1 1 1 1 1 1 1 1 1 1 1 1 1 1 1 1 1 1 1 1 1 1 1 1 1 1 1 1 1 1 1 1 1 1 1 1 1 1 1 1 1 1
      1 1 1 1 1 1 1 1 1 1 1 1 1 1 1 1 1 1 1 1 1 1 1 1 1 1 1 1 1 1 1 1 1 1 1 1 1 1 1 1 1 1 1 1 1 1 1 1 1 1
      1 1 1 1 1 1 1 1 1 1 1 1 1 1 1 1 1 1 1 1 1 1 1 1 1 1 1 1 1 1 1 1 1 1 1 1 1 1 1 1 1 1 1 1 1 1 1 1 1 1
      1 1 1 1 1 1 1 1 1 1 1 1 1 1 1 1 1 1 1 1 1 1 1 1 1 1 1 1 1 1 1 1 1 1 1 1 1 1 1 1 1 1 1 1 1 1 1 1 1 1
      1 1 1 1 1 1 1 1 1 1 1 1 1 1 1 1 1 1 1 1 1 1 1 1 1 1 1 1 1 1 1 1 1 1 1 1 1 1 1 1 1 1 1 1 1 1 1 1 1 1
      1 1 1 1 1 1 1 1 1 1 1 1 1 1 1 1 1 1 1 1 1 1 1 1 1 1 1 1 1 1 1 1 1 1 1 1 1 1 1 1 1 1 1 1 1 1 1 1 1 1
      1 1 1 1 1 1 1 1 1 1 1 1 1 1 1 1 1 1 1 1 1 1 1 1 1 1 1 1 1 1 1 1 1 1 1 1 1 1 1 1 1 1 1 1 1 1 1 1 1 1
      1 1 1 1 1 1 1 1 1 1 1 1 1 1 1 1 1 1 1 1 1 1 1 1 1 1 1 1 1 1 1 1 1 1 1 1 1 1 1 1 1 1 1 1 1 1 1 1 1 1
      1 1 1 1 1 1 1 1 1 1 1 1 1 1 1 1 1 1 1 1 1 1 1 1 1 1 1 1 1 1 1 1 1 1 1 1 1 1 1 1 1 1 1 1 1 1 1 1 1 1
      1 1 1 1 1 1 1 1 1 1 1 1 1 1 1 1 1 1 1 1 1 1 1 1 1 1 1 1 1 1 1 1 1 1 1 1 1 1 1 1 1 1 1 1 1 1 1 1 1 1
      1 1 1 1 1 1 1 1 1 1 1 1 1 1 1 1 1 1 1 1 1 1 1 1 1 1 1 1 1 1 1 1 1 1 1 1 1 1 1 1 1 1 1 1 1 1 1 1 1 1
      1 1 1 1 1 1 1 1 1 1 1 1 1 1 1 1 1 1 1 1 1 1 1 1 1 1 1 1 1 1 1 1 1 1 1 1 1 1 1 1 1 1 1 1 1 1 1 1 1 1
      1 1 1 1 1 1 1 1 1 1 1 1 1 1 1 1 1 1 1 1 1 1 1 1 1 1 1 1 1 1 1 1 1 1 1 1 1 1 1 1 1 1 1 1 1 1 1 1 1 1
      1 1 1 1 1 1 1 1 1 1 1 1 1 1 1 1 1 1 1 1 1 1 1 1 1 1 1 1 1 1 1 1 1 1 1 1 1 1 1 1 1 1 1 1 1 1 1 1 1 1
      1 1 1 1 1 1 1 1 1 1 1 1 1 1 1 1 1 1 1 1 1 1 1 1 1 1 1 1 1 1 1 1 1 1 1 1 1 1 1 1 1 1 1 1 1 1 1 1 1 1
      1 1 1 1 1 1 1 1 1 1 1 1 1 1 1 1 1 1 1 1 1 1 1 1 1 1 1 1 1 1 1 1 1 1 1 1 1 1 1 1 1 1 1 1 1 1 1 1 1 1
      1 1 1 1 1 1 1 1 1 1 1 1 1 1 1 1 1 1 1 1 1 1 1 1 1 1 1 1 1 1 1 1 1 1 1 1 1 1 1 1 1 1 1 1 1 1 1 1 1 1
      1 1 1 1 1 1 1 1 1 1 1 1 1 1 1 1 1 1 1 1 1 1 1 1 1 1 1 1 1 1 1 1 1 1 1 1 1 1 1 1 1 1 1 1 1 1 1 1 1 1
      1 1 1 1 1 1 1 1 1 1 1 1 1 1 1 1 1 1 1 1 1 1 1 1 1 1 1 1 1 1 1 1 1 1 1 1 1 1 1 1 1 1 1 1 1 1 1 1 1 1
      1 1 1 1 1 1 1 1 1 1 1 1 1 1 1 1 1 1 1 1 105 105 105 1 1 1 1 1 1 1 1 1 1 1 1 1 1 1 1 1 1 1 1 1 1 1 1 1 1 1
      1 1 1 1 1 1 1 1 1 1 1 1 1 1 1 1 1 1 1 1 105 105 105 1 1 1 1 1 1 1 1 1 1 1 1 1 1 1 1 1 1 1 1 1 1 1 1 1 1 1
      1 1 1 1 1 1 1 1 1 1 1 1 1 1 1 1 1 1 1 1 105 105 105 1 1 1 1 1 1 105 105 1 1 1 1 1 1 1 1 1 1 1 1 1 1 1 1 1 1 1
      1 1 1 1 1 1 1 1 1 1 1 1 1 1 1 1 1 1 1 1 1 1 1 1 1 1 1 1 1 1 1 1 1 1 1 1 1 1 1 1 1 1 1 1 1 1 1 1 1 1
      1 1 1 1 1 1 1 1 1 1 1 1 1 1 1 1 1 1 1 1 1 1 1 1 1 1 1 1 1 1 1 1 1 1 1 1 1 1 1 1 1 1 1 1 1 1 1 1 1 1
      )
    )
    (tilemap
      (solid #f)
      (z-pos -101)
      (width 50)
      (height 40)
      (tiles
      0 0 0 0 0 0 0 0 0 0 0 0 0 0 0 0 0 0 0 0 0 0 0 0 0 0 0 0 0 0 0 0 0 0 0 0 0 0 0 0 0 0 0 0 0 0 0 0 0 0
      0 0 0 0 0 0 0 0 0 0 0 0 0 0 0 0 0 0 0 0 0 0 0 0 0 0 0 0 0 0 0 0 0 0 0 0 0 0 0 0 0 0 0 0 0 0 0 0 0 0
      0 0 0 2 3 3 3 3 3 3 3 3 4 0 0 0 0 0 0 0 0 0 0 0 0 0 0 0 0 0 0 0 0 0 0 0 0 0 0 0 0 0 0 0 0 0 0 0 0 0
      0 0 0 6 0 0 0 0 0 0 0 0 6 0 0 0 0 0 0 0 0 0 0 0 0 0 0 0 0 0 0 0 0 0 0 0 0 0 0 0 0 0 0 0 0 0 0 0 0 0
      0 0 0 7 0 0 0 0 0 0 0 0 7 0 0 0 0 0 0 0 0 0 0 0 0 0 0 0 0 0 0 0 0 0 0 0 0 0 0 0 0 0 0 0 0 0 0 0 0 0
      0 0 0 7 0 0 0 0 0 0 0 0 8 0 0 0 0 0 0 0 0 0 0 0 0 0 0 0 0 0 0 0 0 0 0 0 0 0 0 0 0 0 0 0 0 0 0 0 0 0
      0 0 0 7 0 0 0 0 0 0 0 0 2 3 3 3 3 4 0 0 0 0 0 0 0 0 0 0 0 0 0 0 0 0 0 0 0 0 0 0 0 0 0 0 0 0 0 0 0 0
      0 0 0 7 0 0 0 0 0 0 0 0 0 0 0 0 0 6 0 0 0 0 0 0 0 0 0 0 0 0 0 0 0 0 0 0 0 0 0 0 0 0 0 0 0 0 0 0 0 0
      0 0 0 7 0 0 0 0 0 0 0 0 0 0 0 0 0 7 0 0 0 0 0 0 0 0 0 0 0 0 0 0 0 2 3 3 3 3 3 3 3 3 3 3 4 6 0 0 0 0
      0 0 0 7 0 0 0 0 0 0 0 0 0 0 0 0 0 7 0 0 0 0 0 0 0 0 0 0 0 2 3 3 3 4 0 0 0 0 0 0 0 0 0 0 0 7 0 0 0 0
      0 0 0 7 0 0 0 0 0 0 0 0 0 0 0 0 0 7 0 0 0 0 0 0 0 0 0 0 0 6 0 0 0 0 0 0 0 0 0 0 0 0 0 0 0 8 6 0 0 0
      0 0 0 8 0 0 0 0 0 0 0 0 0 0 0 0 0 8 0 0 0 0 0 0 0 0 0 0 6 8 0 0 0 0 0 0 0 0 0 0 0 0 0 0 0 0 7 0 0 0
      0 0 0 2 3 3 3 3 3 3 3 3 3 3 3 3 3 4 0 0 0 0 0 0 0 0 0 0 7 0 0 0 0 0 0 0 0 0 0 0 0 0 0 0 0 0 7 0 0 0
      0 0 0 0 0 0 0 0 0 0 0 0 0 0 0 0 0 0 0 0 0 0 0 0 0 0 0 0 7 0 0 0 0 0 0 0 0 0 0 0 0 0 0 0 0 0 7 0 0 0
      0 0 0 0 0 0 0 0 0 2 3 4 0 0 0 0 0 0 0 0 0 0 0 0 0 0 0 0 7 0 0 105 0 0 0 0 0 0 0 0 0 0 0 0 0 6 8 0 0 0
      0 0 0 0 0 0 0 0 0 6 0 6 0 0 0 0 0 0 0 0 0 0 0 0 0 0 0 0 8 0 0 0 0 0 0 0 0 0 0 0 0 0 0 0 0 8 0 0 0 0
      0 0 0 0 0 0 0 0 0 8 0 8 0 0 0 0 0 0 0 0 0 0 0 0 0 0 0 0 205 0 0 0 0 0 0 0 0 0 0 0 0 0 0 0 2 4 0 0 0 0
      0 0 0 0 0 0 0 0 0 2 3 4 0 0 0 0 0 0 0 0 0 0 0 0 0 0 0 0 208 0 0 0 0 0 0 0 0 0 0 0 0 2 3 3 4 0 0 0 0 0
      0 0 0 0 0 0 0 0 0 0 0 0 0 0 0 0 0 0 0 0 0 0 0 0 0 0 0 0 208 0 0 0 0 0 0 0 0 0 0 0 2 4 0 0 0 0 0 0 0 0
      0 0 0 0 0 0 0 0 0 0 0 0 0 0 0 0 0 0 0 0 0 0 0 0 0 0 0 0 208 0 0 0 0 0 0 0 0 0 2 3 4 0 0 0 0 0 0 0 0 0
      0 0 0 0 0 0 6 2 3 3 3 3 3 3 3 3 3 3 3 3 3 3 4 0 0 0 0 0 208 0 0 0 0 0 0 0 0 0 2 4 0 0 0 0 0 0 0 0 0 0
      0 0 0 0 0 0 7 0 0 0 0 0 0 0 0 0 0 0 0 0 0 0 6 0 0 0 0 0 208 0 0 0 0 0 0 0 0 0 0 2 3 4 0 0 0 0 0 0 0 0
      0 0 0 0 0 6 8 0 0 0 0 0 0 0 0 0 0 0 0 0 0 0 7 0 0 0 0 0 208 0 0 0 105 0 105 0 0 0 0 0 0 2 3 3 4 0 0 0 0 0
      0 0 0 0 0 7 0 0 0 0 0 0 0 0 0 0 0 0 0 0 0 0 7 0 0 0 0 0 208 0 0 0 105 0 0 0 0 0 0 0 0 0 0 0 2 3 4 0 0 0
      0 0 0 0 0 7 0 0 0 0 0 0 0 0 0 0 0 0 0 0 0 0 7 0 0 0 0 0 208 0 0 0 0 0 0 0 0 0 0 0 0 0 0 0 0 0 6 0 0 0
      0 0 0 0 0 7 0 0 0 0 0 0 0 0 0 0 0 0 0 0 0 0 7 0 0 0 0 0 211 0 0 0 0 0 0 0 0 0 0 0 0 0 0 0 0 0 7 0 0 0
      0 0 0 0 0 7 0 0 0 0 0 0 0 0 0 0 0 0 0 0 0 0 7 0 0 0 0 0 6 0 0 0 0 0 0 0 0 0 0 0 0 0 0 0 6 5 8 0 0 0
      0 0 0 0 0 7 0 0 0 0 0 0 0 0 0 0 0 0 6 2 3 4 8 0 0 0 0 0 7 0 0 0 0 0 0 0 0 0 0 0 0 0 0 0 7 0 0 0 0 0
      0 0 0 0 0 7 0 0 105 105 105 105 105 105 105 105 0 0 7 0 0 0 0 0 0 0 0 0 8 5 0 0 0 0 0 0 0 0 0 0 0 0 0 0 7 0 0 0 0 0
      0 0 0 0 0 7 0 0 0 0 0 0 0 0 0 0 0 0 7 0 0 0 0 0 0 0 0 0 0 5 5 0 0 0 0 0 0 0 0 0 0 0 0 0 8 6 0 0 0 0
      0 0 0 0 0 8 6 0 0 0 0 0 0 0 0 0 0 0 7 0 0 0 0 0 0 0 0 0 0 0 2 3 4 0 0 0 0 0 0 0 0 0 0 0 0 8 6 0 0 0
      0 0 0 0 0 0 8 2 3 4 7 0 0 0 0 0 0 0 7 0 0 0 0 0 0 0 0 0 0 0 0 0 2 3 4 0 0 0 0 0 0 0 0 0 0 0 7 0 0 0
      0 0 0 0 0 0 0 0 0 0 7 0 0 0 0 0 0 5 8 0 0 0 0 0 0 0 0 0 0 0 0 0 0 0 2 3 4 0 0 0 0 0 0 0 0 0 7 0 0 0
      0 0 0 0 0 0 0 0 0 0 7 0 0 0 2 3 3 4 0 0 0 0 0 0 0 0 0 0 0 0 0 0 0 2 3 3 4 0 0 0 0 0 0 0 0 0 7 0 0 0
      0 0 0 0 0 0 0 0 0 5 7 0 0 0 6 0 0 0 5 2 3 3 4 5 0 0 0 0 2 3 3 3 3 4 0 0 0 0 0 0 0 0 0 0 0 0 7 0 0 0
      0 0 0 0 0 0 0 6 2 4 0 0 0 0 7 0 0 0 6 0 0 0 0 6 0 0 0 6 5 0 0 0 0 0 0 0 0 0 0 0 0 0 0 0 0 6 8 0 0 0
      0 0 0 0 0 0 0 7 0 0 0 0 0 0 7 0 0 0 7 0 0 0 0 7 0 0 0 7 0 0 0 0 0 0 0 0 0 0 0 0 0 0 0 0 0 8 0 0 0 0
      0 0 0 0 0 0 6 8 0 0 0 0 0 0 7 0 0 0 8 0 0 0 0 8 0 0 0 8 0 0 0 0 0 0 0 0 0 0 0 0 0 0 0 2 3 4 0 0 0 0
      0 0 0 0 0 0 7 0 0 0 0 0 0 0 7 0 0 0 5 2 3 3 4 5 0 0 0 2 3 4 0 0 0 0 0 0 0 0 0 2 3 3 3 4 0 0 0 0 0 0
      0 0 0 0 0 0 8 2 3 3 3 3 3 4 8 0 0 0 0 0 0 0 0 0 0 0 0 0 0 2 3 3 3 3 3 3 3 3 3 4 0 0 0 0 0 0 0 0 0 0
      )
    )
    (level
      (name "welcome_to_eia_world.stl")
      (color 1 1 1)
      (x 6)
      (y 7)
    )
    (level
      (name "forgotten_cave.stl")
      (color 1 1 1)
      (x 11)
      (y 7)
    )
    (level
      (name "the_path_is_forking.stl")
      (color 1 1 1)
      (x 11)
      (y 10)
    )
    (level
      (name "fire_in_flying_village.stl")
      (color 1 1 1)
      (x 10)
      (y 19)
    )
    (level
      (name "waterjump.stl")
      (color 1 1 1)
      (x 12)
      (y 23)
    )
    (level
      (name "more_badguys.stl")
      (color 1 1 1)
      (x 20)
      (y 25)
    )
    (level
      (name "ice_mountains.stl")
      (color 1 1 1)
      (x 15)
      (y 28)
    )
    (level
      (name "time_challenge.stl")
      (color 0 1 0)
      (x 8)
      (y 28)
    )
    (level
      (name "underwater_tunnel.stl")
      (color 1 1 1)
      (x 8)
      (y 33)
    )
    (level
      (name "entrance_to_the_eia2_castle.stl")
      (color 1 1 1)
      (x 16)
      (y 37)
    )
    (level
      (name "eia2_castle.stl")
      (color 1 1 0)
      (x 21)
      (y 37)
    )
    (level
      (name "eia4_castle.stl")
      (color 1 1 0)
      (x 29)
      (y 37)
    )
    (level
      (name "holey_ice.stl")
      (color 1 1 1)
      (x 31)
      (y 14)
    )
    (level
      (name "misty_landscape.stl")
      (color 1 1 1)
      (x 37)
      (y 18)
    )
    (level
      (name "lava_flows.stl")
      (color 1 1 1)
      (x 39)
      (y 23)
    )
    (level
      (name "icy_fortress.stl")
      (color 1 1 1)
      (x 39)
      (y 26)
    )
    (level
      (name "iceberg_mountain_range.stl")
      (color 1 1 1)
      (x 33)
      (y 29)
    )
    (level
      (name "a_narrow_tunnel.stl")
      (color 1 1 1)
      (x 42)
      (y 32)
    )
    (level
      (name "campaign.stl")
      (color 0 1 0)
      (x 34)
      (y 22)
    )
    (worldmap-spawnpoint
      (name "main")
      (x 6)
      (y 5)
    )
    (worldmap-spawnpoint
      (name "tele2+")
      (x 8)
      (y 10)
    )
    (worldmap-spawnpoint
      (name "tele2-")
      (x 10)
      (y 16)
    )
    (worldmap-spawnpoint
      (name "tele4+")
      (x 14)
      (y 10)
    )
    (worldmap-spawnpoint
      (name "tele4-")
      (x 39)
      (y 11)
    )
  )
  (tileset "images/ice_world.strf")
)
